"ensembl.gene.id","ensembl.transcript.id","chromosome.name","gene.start","gene.end","strand","transcript.start","transcript.end.","gene.name","transcript.count","gc.content","gene.type","transcript.type","gene.length","transcript.length"
"ENSG00000238390","ENST00000458922",21,31664306,31664482,1,31664306,31664482,"SNORA81",1,41.24,"snoRNA","snoRNA",176,176
"ENSG00000278233","ENST00000612463",21,8212572,8212724,1,8212572,8212724,"RNA5-8S5",1,57.52,"rRNA","rRNA",152,152
"ENSG00000266211","ENST00000580304",21,13406384,13406460,-1,13406384,13406460,"MIR3156-3",1,42.86,"miRNA","miRNA",76,76
"ENSG00000266195","ENST00000583100",21,17506453,17506728,1,17506453,17506728,"RN7SL163P",1,57.97,"misc_RNA","misc_RNA",275,275
"ENSG00000278618","ENST00000621412",21,13724189,13724274,1,13724189,13724274,"MIR8069-2",1,56.98,"miRNA","miRNA",85,85
"ENSG00000226433","ENST00000450830",21,33156632,33159110,1,33156632,33159110,"AP000290.7",1,41.06,"antisense","antisense",2478,2478
"ENSG00000263973","ENST00000585040",21,40212352,40212431,-1,40212352,40212431,"MIR4760",1,33.75,"miRNA","miRNA",79,79
"ENSG00000235312","ENST00000445258",21,30514613,30514799,-1,30514613,30514799,"KRTAP19-10P",1,48.66,"unprocessed_pseudogene","unprocessed_pseudogene",186,186
"ENSG00000276873","ENST00000616808",21,39171462,39171560,-1,39171462,39171560,"uc_338",1,55.56,"misc_RNA","misc_RNA",98,98
"ENSG00000207147","ENST00000384418",21,40513144,40513279,1,40513144,40513279,"SNORA51",1,50,"snoRNA","snoRNA",135,135
"ENSG00000233754","ENST00000420273",21,42781074,42782229,-1,42781074,42782229,"AP001628.7",1,57.61,"lincRNA","lincRNA",1155,1155
"ENSG00000252273","ENST00000516464",21,16035413,16035509,-1,16035413,16035509,"RNU6-426P",1,31.96,"snRNA","snRNA",96,96
"ENSG00000206802","ENST00000384075",21,26190707,26190813,1,26190707,26190813,"RNU6-926P",1,39.25,"snRNA","snRNA",106,106
"ENSG00000201812","ENST00000364942",21,14070871,14070986,1,14070871,14070986,"RNA5SP488",1,60.34,"rRNA","rRNA",115,115
"ENSG00000207638","ENST00000384906",21,16539089,16539169,1,16539089,16539169,"MIR99A",1,53.09,"miRNA","miRNA",80,80
"ENSG00000278433","ENST00000613967",21,43609887,43609989,-1,43609887,43609989,"MIR6070",1,56.31,"miRNA","miRNA",102,102
"ENSG00000275631","ENST00000620684",21,9646825,9647000,1,9646825,9647000,"U1",1,45.45,"snRNA","snRNA",175,175
"ENSG00000264452","ENST00000583496",21,44439035,44439110,1,44439035,44439110,"snoZ6",1,64.47,"snoRNA","snoRNA",75,75
"ENSG00000212609","ENST00000391307",21,19345148,19345312,1,19345148,19345312,"RNU1-139P",1,45.45,"snRNA","snRNA",164,164
"ENSG00000279967","ENST00000624806",21,8101251,8103706,-1,8101251,8103706,"CH507-338C24.3",1,35.67,"TEC","TEC",2455,2455
"ENSG00000260256","ENST00000568332",21,44347767,44348295,-1,44347767,44348295,"AP001063.1",1,53.69,"lincRNA","lincRNA",528,528
"ENSG00000199030","ENST00000362160",21,16539828,16539911,1,16539828,16539911,"MIRLET7C",1,47.62,"miRNA","miRNA",83,83
"ENSG00000160202","ENST00000291554",21,43169008,43172805,1,43169008,43172805,"CRYAA",5,63.16,"protein_coding","protein_coding",3797,3797
"ENSG00000200792","ENST00000363922",21,32377187,32377322,-1,32377187,32377322,"SNORA80A",1,55.88,"snoRNA","snoRNA",135,135
"ENSG00000201025","ENST00000364155",21,16284696,16284768,-1,16284696,16284768,"SNORD74",1,42.47,"snoRNA","snoRNA",72,72
"ENSG00000159110","ENST00000404220",21,33229901,33265675,1,33229971,33265675,"IFNAR2",10,44.16,"protein_coding","protein_coding",35774,35704
"ENSG00000218125","ENST00000406413",21,30526546,30526701,-1,30526546,30526701,"AP000567.27",1,44.87,"unprocessed_pseudogene","unprocessed_pseudogene",155,155
"ENSG00000232884","ENST00000455253",21,14746762,14753863,-1,14746762,14753863,"AF127936.3",2,36.13,"lincRNA","lincRNA",7101,7101
"ENSG00000234730","ENST00000428205",21,21566763,21615437,1,21566763,21615437,"AF241725.4",1,36.14,"lincRNA","lincRNA",48674,48674
"ENSG00000212479","ENST00000391177",21,29180425,29180639,-1,29180425,29180639,"U3",1,52.09,"snoRNA","snoRNA",214,214
"ENSG00000159261","ENST00000342108",21,36460621,36576569,-1,36460621,36576569,"CLDN14",6,46.47,"protein_coding","protein_coding",115948,115948
"ENSG00000252045","ENST00000516236",21,32538299,32538434,1,32538299,32538434,"SNORA33",1,49.26,"snoRNA","snoRNA",135,135
"ENSG00000249493","ENST00000359341",21,14064325,14069087,1,14064325,14069087,"ANKRD20A18P",1,35.73,"unprocessed_pseudogene","unprocessed_pseudogene",4762,4762
"ENSG00000237338","ENST00000446649",21,46151614,46152647,1,46151614,46152647,"FTCD-AS1",1,61.41,"antisense","antisense",1033,1033
"ENSG00000277437","ENST00000614492",21,8208844,8208904,1,8208844,8208904,"MIR3687-1",1,78.69,"miRNA","miRNA",60,60
"ENSG00000275469","ENST00000619419",21,23079284,23079392,1,23079284,23079392,"MIR6130",1,34.86,"miRNA","miRNA",108,108
"ENSG00000156261","ENST00000540844",21,29055805,29073797,-1,29056322,29073797,"CCT8",12,38.32,"protein_coding","protein_coding",17992,17475
"ENSG00000243646","ENST00000290200",21,33266358,33310187,1,33266358,33297234,"IL10RB",7,46.79,"protein_coding","protein_coding",43829,30876
"ENSG00000235772","ENST00000442605",21,42560374,42561934,-1,42560374,42561934,"AP001625.6",1,50.35,"antisense","antisense",1560,1560
"ENSG00000231867","ENST00000429903",21,42508624,42509661,1,42508624,42509661,"AP001625.5",2,42,"sense_intronic","sense_intronic",1037,1037
"ENSG00000182362","ENST00000397701",21,46286337,46297751,1,46286337,46297751,"YBEY",8,53.1,"protein_coding","protein_coding",11414,11414
"ENSG00000225735","ENST00000433383",21,17210469,17211347,-1,17210469,17211347,"NEK4P1",1,40.27,"processed_pseudogene","processed_pseudogene",878,878
"ENSG00000183036","ENST00000328619",21,39867317,39929397,1,39867317,39929397,"PCP4",4,43.6,"protein_coding","protein_coding",62080,62080
"ENSG00000202239","ENST00000365369",21,46525618,46525722,1,46525618,46525722,"RNU6-396P",1,39.05,"snRNA","snRNA",104,104
"ENSG00000280372","ENST00000624662",21,10028361,10029855,-1,10028361,10029855,"bP-21201H5.2",1,32.24,"TEC","TEC",1494,1494
"ENSG00000160282","ENST00000498355",21,46136262,46155567,-1,46136262,46155567,"FTCD",12,58.97,"protein_coding","processed_transcript",19305,19305
"ENSG00000252462","ENST00000516653",21,17431547,17431647,1,17431547,17431647,"RNU6-113P",1,41.58,"snRNA","snRNA",100,100
"ENSG00000236612","ENST00000439851",21,30537278,30537381,-1,30537278,30537381,"KRTAP19-11P",1,43.27,"unprocessed_pseudogene","unprocessed_pseudogene",103,103
"ENSG00000182591","ENST00000332378",21,30880644,30881555,-1,30880644,30881555,"KRTAP11-1",1,53.18,"protein_coding","protein_coding",911,911
"ENSG00000224747","ENST00000443300",21,44469929,44472516,-1,44469929,44472516,"MTCYBP21",1,44.13,"processed_pseudogene","processed_pseudogene",2587,2587
"ENSG00000244362","ENST00000614763",21,30541660,30561314,-1,30541660,30561289,"KRTAP19-7",2,35.27,"protein_coding","protein_coding",19654,19629
"ENSG00000188660","ENST00000448049",21,43446601,43453893,1,43446601,43453893,"LINC00319",2,61.7,"lincRNA","lincRNA",7292,7292
"ENSG00000227999","ENST00000445440",21,44473723,44475097,-1,44473723,44475097,"MTND5P1",1,46.04,"processed_pseudogene","processed_pseudogene",1374,1374
"ENSG00000176054","ENST00000320371",21,28997613,28998033,-1,28997613,28998033,"RPL23P2",1,47.03,"processed_pseudogene","processed_pseudogene",420,420
"ENSG00000238627","ENST00000410986",21,25202207,25202315,1,25202207,25202315,"RNA5SP489",1,44.04,"rRNA","rRNA",108,108
"ENSG00000275523","ENST00000611656",21,39447010,39447069,1,39447010,39447069,"MIR6508",1,48.33,"miRNA","miRNA",59,59
"ENSG00000275167","ENST00000611994",21,45478266,45478326,1,45478266,45478326,"MIR6815",1,55.74,"miRNA","miRNA",60,60
"ENSG00000186925","ENST00000334046",21,30541535,30541864,-1,30541535,30541864,"KRTAP19-6",1,47.58,"protein_coding","protein_coding",329,329
"ENSG00000264580","ENST00000579137",21,42950928,42951014,-1,42950928,42951014,"MIR5692B",1,34.48,"miRNA","miRNA",86,86
"ENSG00000215559","ENST00000451663",21,13909574,13980437,-1,13909574,13979911,"ANKRD20A11P",6,37.2,"transcribed_unprocessed_pseudogene","transcribed_unprocessed_pseudogene",70863,70337
"ENSG00000182670","ENST00000355666",21,37073226,37203112,1,37073271,37203103,"TTC3",25,38.7,"protein_coding","protein_coding",129886,129832
"ENSG00000276529","ENST00000616815",21,44978832,44979274,1,44978832,44979274,"AP001505.10",1,55.76,"lincRNA","lincRNA",442,442
"ENSG00000261706","ENST00000569966",21,44994362,44995185,-1,44994362,44995185,"LINC00165",1,55.46,"lincRNA","lincRNA",823,823
"ENSG00000227702","ENST00000413718",21,41679181,41697336,1,41679181,41697336,"LINC00111",1,50.03,"lincRNA","lincRNA",18155,18155
"ENSG00000228708","ENST00000455391",21,18477358,18486599,-1,18477358,18486599,"AL109763.1",1,32.37,"sense_overlapping","sense_overlapping",9241,9241
"ENSG00000228817","ENST00000436529",21,29370497,29373709,1,29370947,29373709,"BACH1-IT2",3,44.23,"lincRNA","lincRNA",3212,2762
"ENSG00000232401","ENST00000432830",21,41716436,41717580,1,41716436,41717580,"LINC00112",1,55.98,"antisense","antisense",1144,1144
"ENSG00000232118","ENST00000615718",21,29370019,29376339,-1,29370059,29376339,"BACH1-AS1",2,44.41,"lincRNA","lincRNA",6320,6280
"ENSG00000226818","ENST00000413933",21,19244543,19246392,1,19244543,19246392,"SLC6A6P1",1,54.43,"processed_pseudogene","processed_pseudogene",1849,1849
"ENSG00000142168","ENST00000270142",21,31659622,31668931,1,31659622,31668931,"SOD1",4,44.51,"protein_coding","protein_coding",9309,9309
"ENSG00000156273","ENST00000422809",21,29194071,29630751,1,29327129,29630751,"BACH1",13,39.61,"protein_coding","protein_coding",436680,303622
"ENSG00000231231","ENST00000414189",21,38323635,38333421,-1,38323635,38333364,"LINC01423",2,45.33,"lincRNA","lincRNA",9786,9729
"ENSG00000279365","ENST00000624669",21,36485867,36487760,1,36485867,36487760,"KB-176G8.1",1,49.68,"TEC","TEC",1893,1893
"ENSG00000157617","ENST00000380486",21,41885112,41953890,-1,41885112,41953890,"C2CD2",8,47.89,"protein_coding","protein_coding",68778,68778
"ENSG00000215533","ENST00000447125",21,29193480,29288205,1,29193480,29288205,"LINC00189",3,39.07,"sense_overlapping","sense_overlapping",94725,94725
"ENSG00000224924","ENST00000437238",21,20742590,20803216,-1,20742595,20803098,"LINC00320",5,35.72,"lincRNA","lincRNA",60626,60503
"ENSG00000281181","ENST00000627981",21,8437629,8438551,-1,8437629,8438551,"CH507-513H4.3",1,54.82,"lincRNA","lincRNA",922,922
"ENSG00000236545","ENST00000458654",21,41870633,41872054,1,41870633,41872054,"AP001619.3",1,52.88,"antisense","antisense",1421,1421
"ENSG00000230479","ENST00000429588",21,36430360,36481070,1,36430360,36481070,"AP000695.6",1,47.32,"antisense","antisense",50710,50710
"ENSG00000212938","ENST00000391624",21,30592440,30593075,1,30592440,30593075,"KRTAP6-3",1,50.63,"protein_coding","protein_coding",635,635
"ENSG00000279313","ENST00000623347",21,6994374,6997737,-1,6994374,6997737,"CH507-145C22.4",1,37.87,"lincRNA","lincRNA",3363,3363
"ENSG00000227342","ENST00000451410",21,30209151,30211783,-1,30209151,30211783,"LINC00307",1,36.23,"lincRNA","lincRNA",2632,2632
"ENSG00000156284","ENST00000399899",21,30214006,30216073,-1,30214006,30216073,"CLDN8",1,37.23,"protein_coding","protein_coding",2067,2067
"ENSG00000183844","ENST00000479810",21,41304212,41357431,1,41304212,41357431,"FAM3B",6,44.35,"protein_coding","processed_transcript",53219,53219
"ENSG00000279990","ENST00000625020",21,8603547,8603984,1,8603547,8603984,"RPSAP68",1,46.35,"processed_pseudogene","processed_pseudogene",437,437
"ENSG00000273492","ENST00000608591",21,26170871,26217381,1,26170871,26217381,"AP000230.1",2,41.99,"lincRNA","lincRNA",46510,46510
"ENSG00000279720","ENST00000624968",21,9082601,9083101,-1,9082601,9083101,"bP-2171C21.6",1,51.9,"processed_pseudogene","processed_pseudogene",500,500
"ENSG00000232124","ENST00000437557",21,44201290,44202696,1,44201290,44202696,"AP001057.1",1,54.94,"antisense","antisense",1406,1406
"ENSG00000273271","ENST00000609934",21,31666728,31667247,-1,31666728,31667247,"AP000254.8",1,35.77,"antisense","antisense",519,519
"ENSG00000226298","ENST00000454157",21,15694300,15696581,-1,15694300,15696581,"RAD23BLP",1,38.83,"processed_pseudogene","processed_pseudogene",2281,2281
"ENSG00000280018","ENST00000623165",21,6986450,6997765,-1,6986450,6997699,"CH507-154B10.2",3,40.23,"lincRNA","lincRNA",11315,11249
"ENSG00000173231","ENST00000311003",21,13776086,13777266,1,13776086,13777266,"TERF1P1",1,41.74,"processed_pseudogene","processed_pseudogene",1180,1180
"ENSG00000205927","ENST00000382357",21,33025845,33029196,1,33025845,33029196,"OLIG2",3,59.22,"protein_coding","protein_coding",3351,3351
"ENSG00000234008","ENST00000440405",21,35887195,35887807,1,35887195,35887807,"PPP1R2P2",1,42.58,"processed_pseudogene","processed_pseudogene",612,612
"ENSG00000156253","ENST00000493196",21,29004384,29019378,-1,29004384,29019378,"RWDD2B",7,45.42,"protein_coding","protein_coding",14994,14994
"ENSG00000232797","ENST00000443486",21,13792635,13793141,1,13792635,13793141,"FAM207CP",1,60.16,"processed_pseudogene","processed_pseudogene",506,506
"ENSG00000205758","ENST00000290244",21,33589341,33643926,-1,33589386,33641918,"CRYZL1",23,41.59,"protein_coding","protein_coding",54585,52532
"ENSG00000280243","ENST00000624263",21,8845566,8846646,1,8845566,8846646,"MTCO1P1",1,41.63,"processed_pseudogene","processed_pseudogene",1080,1080
"ENSG00000227757","ENST00000454622",21,32913649,33071104,-1,32913649,33071104,"AP000282.2",1,45.97,"antisense","antisense",157455,157455
"ENSG00000205929","ENST00000490358",21,32793564,32813743,-1,32793564,32813743,"C21orf62",4,44.02,"protein_coding","protein_coding",20179,20179
"ENSG00000275139","ENST00000617854",21,45759804,45763758,-1,45759804,45763758,"RP1-101D8.1",1,48.82,"antisense","antisense",3954,3954
"ENSG00000273872","ENST00000614260",21,10612455,10613379,-1,10612455,10613379,"SLC25A15P4",1,42.7,"unprocessed_pseudogene","unprocessed_pseudogene",924,924
"ENSG00000219280","ENST00000407739",21,13476371,13477263,1,13476371,13477263,"VN1R8P",1,43.11,"processed_pseudogene","processed_pseudogene",892,892
"ENSG00000228798","ENST00000413645",21,16630827,16640683,1,16630827,16640633,"AP000473.5",2,38.15,"lincRNA","lincRNA",9856,9806
"ENSG00000226930","ENST00000424290",21,13443373,13489176,-1,13443373,13489176,"GTF2IP2",1,38.79,"unprocessed_pseudogene","unprocessed_pseudogene",45803,45803
"ENSG00000280594","ENST00000626994",21,17611744,17633199,1,17611744,17633199,"AP000432.1",2,41.93,"processed_transcript","lincRNA",21455,21455
"ENSG00000215326","ENST00000429271",21,27143344,27143949,-1,27143344,27143949,"GPX1P2",1,63.86,"processed_pseudogene","processed_pseudogene",605,605
"ENSG00000217026","ENST00000447844",21,27420380,27421023,-1,27420380,27421023,"RPL10P1",1,53.88,"processed_pseudogene","processed_pseudogene",643,643
"ENSG00000207098","ENST00000384370",21,32841861,32841995,-1,32841861,32841995,"SNORA70",1,53.33,"snoRNA","snoRNA",134,134
"ENSG00000237594","ENST00000433071",21,31559245,31560487,1,31559245,31560487,"AP000251.3",1,58.57,"antisense","antisense",1242,1242
"ENSG00000236384","ENST00000412102",21,41711520,41715775,-1,41711520,41715775,"LINC00479",4,52.87,"lincRNA","lincRNA",4255,4255
"ENSG00000225298","ENST00000411460",21,27722379,27751233,1,27722379,27751233,"LINC00113",3,36.07,"lincRNA","lincRNA",28854,28854
"ENSG00000234538","ENST00000453500",21,13839118,13839409,1,13839118,13839409,"ZNF114P1",1,35.96,"processed_pseudogene","processed_pseudogene",291,291
"ENSG00000278181","ENST00000620221",21,17296219,17296596,1,17296219,17296596,"AP000457.2",1,57.67,"processed_pseudogene","processed_pseudogene",377,377
"ENSG00000187026","ENST00000333892",21,30746794,30747233,-1,30746794,30747233,"KRTAP21-2",1,47.95,"protein_coding","protein_coding",439,439
"ENSG00000182093","ENST00000623703",21,39380244,39428528,1,39380354,39414288,"WRB",14,44.24,"protein_coding","nonsense_mediated_decay",48284,33934
"ENSG00000160256","ENST00000291634",21,44940010,44976989,1,44940010,44976989,"FAM207A",5,56.7,"protein_coding","protein_coding",36979,36979
"ENSG00000160214","ENST00000497547",21,43789513,43805293,1,43789513,43805293,"RRP1",7,57.27,"protein_coding","protein_coding",15780,15780
"ENSG00000236471","ENST00000449746",21,15067070,15067837,1,15067070,15067837,"AF127577.12",1,39.71,"lincRNA","lincRNA",767,767
"ENSG00000240432","ENST00000390690",21,30425265,30425968,-1,30425265,30425968,"KRTAP13-3",1,48.58,"protein_coding","protein_coding",703,703
"ENSG00000272825","ENST00000609953",21,44936303,44936954,1,44936303,44936954,"LL21NC02-1C16.2",1,45.25,"antisense","antisense",651,651
"ENSG00000231068","ENST00000444335",21,30718525,30718777,-1,30718525,30718777,"KRTAP21-3",1,36.36,"protein_coding","protein_coding",252,252
"ENSG00000229623","ENST00000438852",21,39235386,39236020,-1,39235386,39236020,"METTL21AP1",1,46.93,"processed_pseudogene","processed_pseudogene",634,634
"ENSG00000215351","ENST00000448832",21,20828127,20828622,-1,20828127,20828622,"PPIAP1",1,46.57,"processed_pseudogene","processed_pseudogene",495,495
"ENSG00000226496","ENST00000441268",21,41141493,41148133,-1,41141493,41148133,"LINC00323",3,49.18,"antisense","antisense",6640,6640
"ENSG00000229086","ENST00000451980",21,33165470,33170649,-1,33165470,33170649,"LINC01548",2,48.98,"lincRNA","lincRNA",5179,5179
"ENSG00000251972","ENST00000516163",21,25943044,25943145,-1,25943044,25943145,"RNU6-123P",1,33.33,"snRNA","snRNA",101,101
"ENSG00000252963","ENST00000517154",21,20356653,20356896,1,20356653,20356896,"RN7SKP147",1,42.62,"misc_RNA","misc_RNA",243,243
"ENSG00000275664","ENST00000610482",21,8205851,8205940,1,8205851,8205940,"pRNA",1,75.56,"misc_RNA","misc_RNA",89,89
"ENSG00000279167","ENST00000625098",21,8701461,8701562,1,8701461,8701562,"bP-2168N6.3",1,44.12,"processed_pseudogene","processed_pseudogene",101,101
"ENSG00000270139","ENST00000602454",21,16417139,16419080,-1,16417139,16419080,"AP001172.3",1,35.53,"lincRNA","lincRNA",1941,1941
"ENSG00000214976","ENST00000399358",21,16094415,16095372,-1,16094415,16095372,"VDAC2P1",1,41.44,"processed_pseudogene","processed_pseudogene",957,957
"ENSG00000235023","ENST00000424890",21,42648271,42651244,-1,42648271,42651244,"AP001626.2",1,56.12,"antisense","antisense",2973,2973
"ENSG00000215386","ENST00000635845",21,15928296,16627397,1,15928296,16488329,"MIR99AHG",20,35.47,"lincRNA","lincRNA",699101,560033
"ENSG00000280075","ENST00000623929",21,9810381,9810503,-1,9810381,9810503,"RP11-555K2.1",1,52.03,"processed_pseudogene","processed_pseudogene",122,122
"ENSG00000237232","ENST00000412906",21,42009194,42024924,1,42009194,42024866,"ZNF295-AS1",3,51.34,"lincRNA","lincRNA",15730,15672
"ENSG00000215005","ENST00000447985",21,28887280,28889272,-1,28887280,28889272,"HSPD1P7",1,42.15,"processed_pseudogene","processed_pseudogene",1992,1992
"ENSG00000173276","ENST00000398505",21,41986831,42010387,-1,41986831,42010357,"ZBTB21",8,42.8,"protein_coding","protein_coding",23556,23526
"ENSG00000236677","ENST00000436303",21,36060432,36064408,1,36060432,36064408,"AP000688.11",1,47.6,"antisense","antisense",3976,3976
"ENSG00000189089","ENST00000408914",21,36050214,36051377,1,36050214,36051377,"RIMKLBP1",1,47.85,"processed_pseudogene","processed_pseudogene",1163,1163
"ENSG00000279208","ENST00000624041",21,9369285,9376645,-1,9369285,9376645,"bP-21264C1.1",1,35.59,"unprocessed_pseudogene","unprocessed_pseudogene",7360,7360
"ENSG00000159212","ENST00000360731",21,34669389,34718227,1,34669389,34718227,"CLIC6",2,45.73,"protein_coding","protein_coding",48838,48838
"ENSG00000279321","ENST00000624226",21,9913117,9914846,1,9913117,9914713,"RP11-555K2.4",2,35.09,"lincRNA","lincRNA",1729,1596
"ENSG00000255568","ENST00000603064",21,39313935,39314962,1,39313935,39314962,"BRWD1-AS2",1,59.24,"antisense","antisense",1027,1027
"ENSG00000238141","ENST00000423274",21,39315707,39323218,1,39315707,39323218,"BRWD1-AS1",1,45.53,"antisense","antisense",7511,7511
"ENSG00000203616","ENST00000366423",21,13936993,13937325,-1,13936993,13937325,"RHOT1P2",1,42.04,"processed_pseudogene","processed_pseudogene",332,332
"ENSG00000231986","ENST00000441465",21,23888798,23890541,-1,23888798,23890541,"AP000474.1",1,34.81,"lincRNA","lincRNA",1743,1743
"ENSG00000226580","ENST00000445481",21,17500679,17500824,-1,17500679,17500824,"RPL39P40",1,39.73,"processed_pseudogene","processed_pseudogene",145,145
"ENSG00000184385","ENST00000329015",21,42102134,42108534,-1,42102134,42108534,"UMODL1-AS1",1,55.23,"sense_overlapping","sense_overlapping",6400,6400
"ENSG00000160224","ENST00000530812",21,44285838,44298648,1,44285838,44298648,"AIRE",5,63.87,"protein_coding","retained_intron",12810,12810
"ENSG00000155313","ENST00000400183",21,15730025,15880069,1,15730025,15880069,"USP25",10,35.41,"protein_coding","protein_coding",150044,150044
"ENSG00000230982","ENST00000419906",21,46653558,46654022,-1,46653558,46654022,"DSTNP1",1,43.44,"processed_pseudogene","processed_pseudogene",464,464
"ENSG00000224018","ENST00000448063",21,24155170,24188342,-1,24155170,24188342,"AP000470.2",1,35.15,"lincRNA","lincRNA",33172,33172
"ENSG00000232855","ENST00000433310",21,28439346,28674848,-1,28439346,28674848,"AF131217.1",3,37.69,"lincRNA","lincRNA",235502,235502
"ENSG00000226935","ENST00000412526",21,28539318,28540355,1,28539318,28540355,"LINC00161",2,40.56,"lincRNA","lincRNA",1037,1037
"ENSG00000183640","ENST00000329621",21,30812697,30813252,-1,30812697,30813252,"KRTAP8-1",1,51.62,"protein_coding","protein_coding",555,555
"ENSG00000160190","ENST00000398341",21,42496008,42581440,1,42499632,42581440,"SLC37A1",9,48.79,"protein_coding","protein_coding",85432,81808
"ENSG00000232539","ENST00000453716",21,33057829,33064983,1,33057829,33064983,"LINC00945",1,49.43,"lincRNA","lincRNA",7154,7154
"ENSG00000228184","ENST00000444901",21,13525599,13528579,1,13525599,13528579,"SNX19P1",1,49.88,"processed_pseudogene","processed_pseudogene",2980,2980
"ENSG00000233215","ENST00000420255",21,22008944,22098459,-1,22009158,22098459,"AP000472.2",3,35.1,"lincRNA","lincRNA",89515,89301
"ENSG00000233783","ENST00000600590",21,25928754,25942686,1,25934312,25942686,"AP001442.2",7,40.47,"processed_transcript","antisense",13932,8374
"ENSG00000187766","ENST00000334662",21,44612079,44612954,1,44612079,44612954,"KRTAP10-8",1,65.87,"protein_coding","protein_coding",875,875
"ENSG00000225731","ENST00000437426",21,42733594,42741758,-1,42733594,42741758,"AP001627.1",1,49.8,"antisense","antisense",8164,8164
"ENSG00000231123","ENST00000423089",21,38238227,38238664,-1,38238227,38238664,"SPATA20P1",1,57.08,"processed_pseudogene","processed_pseudogene",437,437
"ENSG00000225637","ENST00000435702",21,43363332,43366566,1,43363332,43366566,"AP001046.6",1,58.58,"lincRNA","lincRNA",3234,3234
"ENSG00000179381","ENST00000431829",21,13544282,13545185,-1,13544282,13545185,"OR4K11P",1,43.03,"processed_pseudogene","processed_pseudogene",903,903
"ENSG00000156265","ENST00000341618",21,29077471,29175889,1,29077633,29175889,"MAP3K7CL",16,40.51,"protein_coding","protein_coding",98418,98256
"ENSG00000228159","ENST00000427446",21,13546033,13558461,1,13546033,13558461,"AP001465.5",1,33.34,"lincRNA","lincRNA",12428,12428
"ENSG00000266133","ENST00000584048",21,26953961,26954043,1,26953961,26954043,"MIR4759",1,31.33,"miRNA","miRNA",82,82
"ENSG00000218549","ENST00000406538",21,13581044,13582004,-1,13581044,13582004,"OR4K12P",1,40.79,"processed_pseudogene","processed_pseudogene",960,960
"ENSG00000265841","ENST00000580069",21,18686090,18686164,-1,18686090,18686164,"MIR548X",1,33.33,"miRNA","miRNA",74,74
"ENSG00000199598","ENST00000362728",21,43919795,43919901,-1,43919795,43919901,"RNU6-859P",1,47.66,"snRNA","snRNA",106,106
"ENSG00000252950","ENST00000517141",21,32563075,32563210,1,32563075,32563210,"RNA5SP490",1,41.18,"rRNA","rRNA",135,135
"ENSG00000232837","ENST00000433952",21,38974429,38977774,-1,38974429,38977774,"AF064858.7",1,46.47,"lincRNA","lincRNA",3345,3345
"ENSG00000279477","ENST00000623518",21,7003248,7007022,-1,7003248,7007022,"CH507-236L23.4",1,53.67,"unprocessed_pseudogene","unprocessed_pseudogene",3774,3774
"ENSG00000223431","ENST00000443620",21,44472895,44473739,1,44472895,44473739,"MTND6P21",1,42.25,"processed_pseudogene","processed_pseudogene",844,844
"ENSG00000184221","ENST00000382348",21,33070144,33072420,1,33070144,33072420,"OLIG1",3,64.6,"protein_coding","protein_coding",2276,2276
"ENSG00000275692","ENST00000617390",21,8432530,8432621,1,8432530,8432621,"MIR6724-4",1,83.7,"miRNA","miRNA",91,91
"ENSG00000239023","ENST00000458992",21,16718998,16719157,1,16718998,16719157,"RNU1-98P",1,51.25,"snRNA","snRNA",159,159
"ENSG00000263969","ENST00000579533",21,37215605,37215903,1,37215605,37215903,"RN7SL678P",1,55.18,"misc_RNA","misc_RNA",298,298
"ENSG00000228709","ENST00000449713",21,44485577,44490288,1,44485577,44490288,"AP001065.15",1,47.62,"lincRNA","lincRNA",4711,4711
"ENSG00000221837","ENST00000397911",21,44627123,44628293,1,44627123,44628293,"KRTAP10-9",3,66.61,"protein_coding","protein_coding",1170,1170
"ENSG00000205581","ENST00000492280",21,39342315,39349647,-1,39342315,39349344,"HMGN1",20,42.26,"protein_coding","retained_intron",7332,7029
"ENSG00000187175","ENST00000391617",21,44681576,44682163,-1,44681576,44682163,"KRTAP12-1",1,60.37,"protein_coding","protein_coding",587,587
"ENSG00000205445","ENST00000391621",21,44550357,44551505,-1,44550357,44551505,"KRTAP10-2",2,66.23,"protein_coding","protein_coding",1148,1148
"ENSG00000212136","ENST00000390834",21,37045530,37045636,1,37045530,37045636,"RNU6-696P",1,42.99,"snRNA","snRNA",106,106
"ENSG00000184809","ENST00000380612",21,39597147,39612821,-1,39597147,39612441,"B3GALT5-AS1",4,48.68,"antisense","antisense",15674,15294
"ENSG00000275708","ENST00000615959",21,8208473,8208652,1,8208473,8208652,"MIR3648-1",1,83.89,"miRNA","miRNA",179,179
"ENSG00000276633","ENST00000618749",21,45870854,45873345,1,45870854,45873345,"AJ011931.1",1,57.91,"sense_intronic","sense_intronic",2491,2491
"ENSG00000211590","ENST00000390235",21,35720715,35720808,1,35720715,35720808,"MIR802",1,37.23,"miRNA","miRNA",93,93
"ENSG00000264462","ENST00000581792",21,8986999,8987178,1,8986999,8987178,"MIR3648-2",1,83.89,"miRNA","miRNA",179,179
"ENSG00000223822","ENST00000447052",21,23390258,23390996,1,23390258,23390996,"EEF1A1P1",1,48.44,"processed_pseudogene","processed_pseudogene",738,738
"ENSG00000171189","ENST00000399914",21,29536933,29940033,-1,29536933,29940022,"GRIK1",8,38.04,"protein_coding","protein_coding",403100,403089
"ENSG00000237604","ENST00000411956",21,44175489,44176453,1,44175489,44176453,"AP001056.1",1,55.54,"lincRNA","lincRNA",964,964
"ENSG00000205622","ENST00000415824",21,38863676,38956467,-1,38880307,38956467,"AF064858.6",7,43.68,"lincRNA","lincRNA",92791,76160
"ENSG00000228677","ENST00000424733",21,37187666,37193926,-1,37187666,37193926,"TTC3-AS1",1,39.27,"antisense","antisense",6260,6260
"ENSG00000207863","ENST00000385128",21,16590237,16590325,1,16590237,16590325,"MIR125B2",1,49.44,"miRNA","miRNA",88,88
"ENSG00000280170","ENST00000624569",21,35898055,35898429,-1,35898055,35898429,"AP000687.1",1,48.53,"protein_coding","protein_coding",374,374
"ENSG00000234293","ENST00000429843",21,29496047,29500386,1,29496047,29500386,"BACH1-IT3",1,43.39,"sense_intronic","sense_intronic",4339,4339
"ENSG00000227039","ENST00000441379",21,44921051,44929678,1,44921051,44929678,"ITGB2-AS1",6,49.14,"antisense","antisense",8627,8627
"ENSG00000279156","ENST00000623771",21,18917213,18917429,1,18917213,18917429,"RP4-646P19.1",1,40.55,"TEC","TEC",216,216
"ENSG00000160185","ENST00000319294",21,42403447,42447681,1,42403915,42447681,"UBASH3A",9,49.32,"protein_coding","protein_coding",44234,43766
"ENSG00000159267","ENST00000336648",21,36750888,36990236,-1,36750888,36990236,"HLCS",7,44.35,"protein_coding","protein_coding",239348,239348
"ENSG00000186970","ENST00000334067",21,30440275,30440945,1,30440275,30440945,"KRTAP15-1",1,46.8,"protein_coding","protein_coding",670,670
"ENSG00000142178","ENST00000270162",21,43414515,43427128,-1,43414515,43427128,"SIK1",2,56.06,"protein_coding","protein_coding",12613,12613
"ENSG00000275464","ENST00000617716",21,5130871,5154734,-1,5130871,5154734,"CH507-9B2.5",8,56.9,"protein_coding","protein_coding",23863,23863
"ENSG00000230978","ENST00000430635",21,34723807,34737181,-1,34723807,34737181,"LINC00160",1,43.93,"lincRNA","lincRNA",13374,13374
"ENSG00000234380","ENST00000420877",21,34745757,34784886,1,34745757,34784886,"LINC01426",2,43.06,"antisense","antisense",39129,39129
"ENSG00000159147","ENST00000439593",21,33559542,33588708,-1,33559542,33578363,"DONSON",13,37.85,"protein_coding","nonsense_mediated_decay",29166,18821
"ENSG00000232698","ENST00000423967",21,44206525,44207399,-1,44206525,44207399,"AP001058.3",1,56.23,"lincRNA","lincRNA",874,874
"ENSG00000225906","ENST00000438328",21,22882582,22884000,1,22882582,22884000,"AP000949.1",1,39.04,"processed_pseudogene","processed_pseudogene",1418,1418
"ENSG00000184351","ENST00000390689",21,30479699,30480344,-1,30479699,30480344,"KRTAP19-1",1,42.72,"protein_coding","protein_coding",645,645
"ENSG00000236519","ENST00000417820",21,44802577,44804717,1,44802577,44804717,"LINC01424",1,45.59,"antisense","antisense",2140,2140
"ENSG00000231236","ENST00000420186",21,27358885,27448579,-1,27358885,27448579,"AP001604.3",1,37.2,"lincRNA","lincRNA",89694,89694
"ENSG00000244624","ENST00000334664",21,30616425,30616699,1,30616425,30616699,"KRTAP20-1",1,45.09,"protein_coding","protein_coding",274,274
"ENSG00000270652","ENST00000604662",21,36943267,36944125,1,36943267,36944125,"DPRXP5",1,46.33,"processed_pseudogene","processed_pseudogene",858,858
"ENSG00000225043","ENST00000450007",21,46420553,46421034,-1,46420553,46421034,"RPL18AP2",1,56.02,"processed_pseudogene","processed_pseudogene",481,481
"ENSG00000206105","ENST00000382828",21,30620627,30620850,1,30620627,30620850,"KRTAP20-4",1,53.57,"protein_coding","protein_coding",223,223
"ENSG00000198390","ENST00000355459",21,30396074,30396822,1,30396074,30396822,"KRTAP13-1",1,51,"protein_coding","protein_coding",748,748
"ENSG00000224649","ENST00000430001",21,29182027,29187795,-1,29182027,29187795,"AF124730.4",1,39.83,"antisense","antisense",5768,5768
"ENSG00000274749","ENST00000621162",21,30829039,30829759,-1,30829039,30829759,"KRTAP7-1",1,45.77,"protein_coding","protein_coding",720,720
"ENSG00000248476","ENST00000504298",21,29351634,29361894,1,29351634,29361894,"BACH1-IT1",1,43.74,"sense_intronic","sense_intronic",10260,10260
"ENSG00000280164","ENST00000623892",21,6721812,6725209,1,6721812,6725209,"CH507-254M2.3",1,38.32,"lincRNA","lincRNA",3397,3397
"ENSG00000279177","ENST00000624906",21,7626344,7627528,-1,7626344,7627528,"CH507-338C24.2",1,56.12,"processed_pseudogene","processed_pseudogene",1184,1184
"ENSG00000182586","ENST00000328344",21,45234340,45258730,1,45234352,45258730,"LINC00334",2,49.45,"lincRNA","lincRNA",24390,24378
"ENSG00000160298","ENST00000397682",21,46300181,46323875,-1,46301130,46323875,"C21orf58",10,52.19,"protein_coding","protein_coding",23694,22745
"ENSG00000232969","ENST00000426029",21,44339376,44340470,1,44339376,44340470,"AP001062.9",1,49.68,"antisense","antisense",1094,1094
"ENSG00000234083","ENST00000433344",21,27954922,27985295,1,27954922,27985295,"AJ006995.3",1,36.19,"lincRNA","lincRNA",30373,30373
"ENSG00000229007","ENST00000448649",21,32496812,32497311,1,32496812,32497311,"EXOSC3P1",1,40.2,"processed_pseudogene","processed_pseudogene",499,499
"ENSG00000279998","ENST00000623678",21,6789592,6812297,1,6789592,6812297,"CH507-210P18.1",1,38.21,"lincRNA","lincRNA",22705,22705
"ENSG00000278955","ENST00000624937",21,6858539,6897263,1,6858539,6897263,"MIR8069-1",2,39.78,"lincRNA","lincRNA",38724,38724
"ENSG00000280172","ENST00000623131",21,6897291,6899280,1,6897291,6899280,"CH507-210P18.3",1,63.57,"processed_pseudogene","processed_pseudogene",1989,1989
"ENSG00000232079","ENST00000426534",21,28048404,28137611,1,28048404,28137611,"AL035610.1",7,35.65,"processed_transcript","lincRNA",89207,89207
"ENSG00000236532","ENST00000453420",21,28116094,28228667,-1,28116094,28228667,"AL035610.2",3,36.7,"lincRNA","lincRNA",112573,112573
"ENSG00000234289","ENST00000599962",21,43565189,43565648,1,43565189,43565648,"H2BFS",1,60.22,"protein_coding","protein_coding",459,459
"ENSG00000233640","ENST00000418755",21,30436466,30436964,-1,30436466,30436964,"KRTAP13-5P",1,52.71,"unprocessed_pseudogene","unprocessed_pseudogene",498,498
"ENSG00000280614","ENST00000625598",21,8393419,8394341,-1,8393419,8394341,"CH507-513H4.4",1,54.82,"lincRNA","lincRNA",922,922
"ENSG00000215369","ENST00000456825",21,17894193,17894485,-1,17894193,17894485,"RPL37P3",1,45.05,"processed_pseudogene","processed_pseudogene",292,292
"ENSG00000224309","ENST00000435744",21,13038160,13067033,1,13038208,13067033,"ANKRD30BP2",4,36.72,"transcribed_unprocessed_pseudogene","transcribed_unprocessed_pseudogene",28873,28825
"ENSG00000278884","ENST00000625184",21,7020599,7025166,1,7020599,7025166,"CH507-236L23.1",1,32.22,"lincRNA","lincRNA",4567,4567
"ENSG00000159140","ENST00000356577",21,33542618,33577481,1,33542618,33577481,"SON",21,38.94,"protein_coding","protein_coding",34863,34863
"ENSG00000197934","ENST00000357401",21,26393635,26569252,1,26405943,26569252,"CYYR1-AS1",2,38.21,"antisense","antisense",175617,163309
"ENSG00000232692","ENST00000429340",21,26378552,26471698,1,26378552,26471102,"AP001596.6",4,39.79,"antisense","antisense",93146,92550
"ENSG00000159086","ENST00000331923",21,32733899,32771858,-1,32733899,32771858,"PAXBP1",9,38.15,"protein_coding","protein_coding",37959,37959
"ENSG00000233818","ENST00000428667",21,36445731,36532408,1,36445731,36532408,"AP000695.4",2,47.71,"antisense","antisense",86677,86677
"ENSG00000280108","ENST00000624445",21,13305171,13314664,1,13305171,13314664,"AJ239318.1",1,39.68,"protein_coding","protein_coding",9493,9493
"ENSG00000230212","ENST00000535199",21,36069642,36126640,-1,36069642,36126640,"AP000688.14",2,43.47,"sense_intronic","sense_intronic",56998,56998
"ENSG00000223741","ENST00000433951",21,36485983,36487411,-1,36485983,36487411,"PSMD4P1",1,52.9,"processed_pseudogene","processed_pseudogene",1428,1428
"ENSG00000186930","ENST00000334897",21,30598590,30598902,-1,30598590,30598902,"KRTAP6-2",1,55.27,"protein_coding","protein_coding",312,312
"ENSG00000277067","ENST00000623095",21,7048891,7087229,1,7048891,7087097,"CH507-254M2.1",6,39.64,"lincRNA","lincRNA",38338,38206
"ENSG00000184029","ENST00000398948",21,37951425,38121360,-1,37951425,38121339,"DSCR4",3,41.53,"protein_coding","protein_coding",169935,169914
"ENSG00000233767","ENST00000428242",21,46072085,46072248,-1,46072085,46072248,"PSMA6P3",1,42.07,"processed_pseudogene","processed_pseudogene",163,163
"ENSG00000183067","ENST00000380588",21,39745407,39802096,1,39745407,39802096,"IGSF5",3,42.49,"protein_coding","protein_coding",56689,56689
"ENSG00000227438","ENST00000454245",21,46093264,46097530,-1,46093264,46097530,"AP001471.1",1,57.23,"antisense","antisense",4266,4266
"ENSG00000234107","ENST00000458495",21,31840341,31840858,1,31840341,31840858,"TPT1P1",1,41.31,"processed_pseudogene","processed_pseudogene",517,517
"ENSG00000261610","ENST00000565959",21,32259804,32261585,-1,32259804,32261585,"AP000265.1",1,44.61,"lincRNA","lincRNA",1781,1781
"ENSG00000234880","ENST00000434081",21,44989864,44994086,-1,44989864,44994086,"LINC00163",2,63.39,"lincRNA","lincRNA",4222,4222
"ENSG00000232886","ENST00000430064",21,16862875,16873691,-1,16862875,16873691,"AF212831.2",1,35.13,"lincRNA","lincRNA",10816,10816
"ENSG00000280081","ENST00000623554",21,9781918,9814009,-1,9781918,9812602,"MGC39584",3,43.6,"lincRNA","lincRNA",32091,30684
"ENSG00000279783","ENST00000624130",21,9810501,9810848,1,9810501,9810848,"RP11-555K2.2",1,53.45,"processed_pseudogene","processed_pseudogene",347,347
"ENSG00000198054","ENST00000478613",21,38121451,38188016,1,38121451,38156511,"DSCR8",8,40.76,"protein_coding","processed_transcript",66565,35060
"ENSG00000236056","ENST00000450472",21,29222321,29223257,1,29222321,29223257,"GAPDHP14",1,49.95,"processed_pseudogene","processed_pseudogene",936,936
"ENSG00000278996","ENST00000623664",21,8197620,8227646,1,8197620,8227646,"CH507-513H4.1",1,61.22,"lincRNA","lincRNA",30026,30026
"ENSG00000229962","ENST00000419694",21,25515473,25518338,-1,25515473,25518338,"AP000221.1",1,31.33,"lincRNA","lincRNA",2865,2865
"ENSG00000166265","ENST00000299340",21,26466209,26573284,-1,26466209,26573284,"CYYR1",2,37.29,"protein_coding","protein_coding",107075,107075
"ENSG00000234883","ENST00000456917",21,25561909,25575168,1,25561909,25575168,"MIR155HG",2,37.7,"lincRNA","lincRNA",13259,13259
"ENSG00000183778","ENST00000380620",21,39556442,39673137,1,39556442,39673137,"B3GALT5",6,44.29,"protein_coding","protein_coding",116695,116695
"ENSG00000198618","ENST00000358455",21,18857779,18858276,1,18857779,18858276,"PPIAP22",1,49,"processed_pseudogene","processed_pseudogene",497,497
"ENSG00000232360","ENST00000427911",21,32844367,32849934,-1,32844367,32849934,"AP000281.2",1,40.86,"antisense","antisense",5567,5567
"ENSG00000185658","ENST00000333229",21,39184176,39321559,-1,39184176,39313819,"BRWD1",16,38.65,"protein_coding","protein_coding",137383,129643
"ENSG00000260583","ENST00000567517",21,25582770,25583326,-1,25582770,25583326,"AP000223.42",1,44.17,"antisense","antisense",556,556
"ENSG00000222018","ENST00000410005",21,34400317,34401072,-1,34400317,34401072,"C21orf140",1,42.86,"protein_coding","protein_coding",755,755
"ENSG00000279213","ENST00000625014",21,8801362,8801880,-1,8801362,8801880,"SNX18P10",1,52.41,"processed_pseudogene","processed_pseudogene",518,518
"ENSG00000275993","ENST00000613488",21,6111134,6123739,1,6111134,6123739,"CH507-42P11.8",2,56.05,"protein_coding","protein_coding",12605,12605
"ENSG00000228930","ENST00000429327",21,45376191,45376382,-1,45376191,45376382,"MTCO1P3",1,47.4,"processed_pseudogene","processed_pseudogene",191,191
"ENSG00000226543","ENST00000449877",21,43855890,43856342,-1,43855890,43856342,"MYL6P1",1,57.17,"processed_pseudogene","processed_pseudogene",452,452
"ENSG00000280604","ENST00000626237",21,45914296,45919483,1,45914296,45919483,"PCBP3-OT1",1,54.93,"sense_overlapping","sense_overlapping",5187,5187
"ENSG00000233756","ENST00000441910",21,40615378,40630767,-1,40615378,40630767,"DSCAM-IT1",2,40.53,"sense_intronic","sense_intronic",15389,15389
"ENSG00000237138","ENST00000437109",21,32020966,32021782,-1,32020966,32021782,"HUNK-AS1",1,54.59,"antisense","antisense",816,816
"ENSG00000142149","ENST00000270112",21,31873315,32044633,1,31873315,32004064,"HUNK",4,45.87,"protein_coding","protein_coding",171318,130749
"ENSG00000278961","ENST00000624951",21,7788703,7793954,-1,7788703,7793954,"CH507-396I9.3",1,41.64,"protein_coding","protein_coding",5251,5251
"ENSG00000224602","ENST00000418544",21,16121310,16121644,-1,16121310,16121644,"RPS26P5",1,46.57,"processed_pseudogene","processed_pseudogene",334,334
"ENSG00000280432","ENST00000624971",21,16525919,16527019,1,16525919,16527019,"AP000962.1",1,41.42,"TEC","TEC",1100,1100
"ENSG00000269950","ENST00000602654",21,16574718,16582637,-1,16574718,16582637,"AP000962.2",1,33.4,"lincRNA","lincRNA",7919,7919
"ENSG00000270071","ENST00000602921",21,16291791,16308133,-1,16291791,16308133,"AP001172.2",1,35.36,"lincRNA","lincRNA",16342,16342
"ENSG00000205670","ENST00000495363",21,34375480,34407866,1,34375561,34407866,"SMIM11A",7,47.19,"protein_coding","processed_transcript",32386,32305
"ENSG00000241728","ENST00000444409",21,44328944,44330221,-1,44328944,44330221,"AP001062.8",2,60.09,"sense_overlapping","sense_overlapping",1277,1277
"ENSG00000280800","ENST00000631211",21,8210384,8211306,-1,8210384,8211306,"CH507-513H4.6",1,54.82,"lincRNA","lincRNA",922,922
"ENSG00000237945","ENST00000596365",21,33915534,33977691,1,33915534,33969586,"LINC00649",20,43.18,"antisense","antisense",62157,54052
"ENSG00000280441","ENST00000623860",21,8380665,8410645,1,8380665,8410645,"CH507-528H12.1",1,61.06,"lincRNA","lincRNA",29980,29980
"ENSG00000275496","ENST00000621924",21,6228966,6267317,-1,6228966,6267304,"CH507-24F1.2",7,39.65,"lincRNA","lincRNA",38351,38338
"ENSG00000273104","ENST00000608665",21,34412200,34412587,1,34412200,34412587,"CMP21-97G8.1",1,36.86,"lincRNA","lincRNA",387,387
"ENSG00000243627","ENST00000450895",21,34418715,34423966,-1,34418715,34423966,"AP000322.53",1,41.64,"protein_coding","protein_coding",5251,5251
"ENSG00000229289","ENST00000424219",21,19130523,19134423,1,19130523,19134423,"AP000431.2",1,33.53,"lincRNA","lincRNA",3900,3900
"ENSG00000232263","ENST00000416044",21,30289145,30289514,-1,30289145,30289514,"KRTAP25-1",1,41.35,"protein_coding","protein_coding",369,369
"ENSG00000184274","ENST00000441947",21,45300245,45305257,-1,45300245,45305257,"LINC00315",1,62.48,"lincRNA","lincRNA",5012,5012
"ENSG00000237527","ENST00000416182",21,21655038,21686329,-1,21655038,21686329,"AF241725.6",1,35.12,"lincRNA","lincRNA",31291,31291
"ENSG00000278903","ENST00000624576",21,6318434,6360415,1,6318434,6360415,"CH507-145C22.1",5,38.75,"lincRNA","lincRNA",41981,41981
"ENSG00000227406","ENST00000444889",21,39373763,39377066,-1,39373763,39377066,"RNF6P1",1,44.31,"processed_pseudogene","processed_pseudogene",3303,3303
"ENSG00000142192","ENST00000359726",21,25880550,26171128,-1,25880551,26171128,"APP",17,39.73,"protein_coding","protein_coding",290578,290577
"ENSG00000241945","ENST00000291576",21,44107290,44131181,1,44107290,44131181,"PWP2",6,56.95,"protein_coding","protein_coding",23891,23891
"ENSG00000197683","ENST00000360542",21,30319124,30320316,-1,30319124,30320316,"KRTAP26-1",1,47.61,"protein_coding","protein_coding",1192,1192
"ENSG00000280082","ENST00000623768",21,15346652,15346738,1,15346652,15346738,"AF246928.1",1,36.78,"TEC","TEC",86,86
"ENSG00000231620","ENST00000433210",21,19301613,19303739,1,19301613,19303739,"AP000855.4",1,31.97,"lincRNA","lincRNA",2126,2126
"ENSG00000272015","ENST00000606322",21,38894785,38894867,1,38894785,38894867,"SNORA62",1,43.37,"snoRNA","snoRNA",82,82
"ENSG00000207503","ENST00000384772",21,41539206,41539326,1,41539206,41539326,"SNORA32",1,47.11,"snoRNA","snoRNA",120,120
"ENSG00000207097","ENST00000384369",21,13047583,13047689,1,13047583,13047689,"RNU6-614P",1,41.12,"snRNA","snRNA",106,106
"ENSG00000206107","ENST00000382835",21,30337013,30337694,-1,30337013,30337694,"KRTAP27-1",1,47.36,"protein_coding","protein_coding",681,681
"ENSG00000188681","ENST00000416067",21,9068361,9129752,-1,9068361,9129752,"TEKT4P2",2,45.63,"transcribed_unprocessed_pseudogene","processed_transcript",61391,61391
"ENSG00000232687","ENST00000412942",21,29127701,29128188,-1,29127701,29128188,"RPL12P9",1,45.49,"processed_pseudogene","processed_pseudogene",487,487
"ENSG00000171587","ENST00000400454",21,40010999,40847139,-1,40010999,40847139,"DSCAM",3,40.93,"protein_coding","protein_coding",836140,836140
"ENSG00000265007","ENST00000581194",21,30375294,30375378,-1,30375294,30375378,"MIR4327",1,54.12,"miRNA","miRNA",84,84
"ENSG00000154654","ENST00000400546",21,20998315,21543329,1,20998315,21543329,"NCAM2",5,34.03,"protein_coding","protein_coding",545014,545014
"ENSG00000226501","ENST00000451645",21,33334571,33335096,1,33334571,33335096,"USF1P1",1,54.75,"processed_pseudogene","processed_pseudogene",525,525
"ENSG00000160188","ENST00000291536",21,42472486,42496354,-1,42472486,42496354,"RSPH1",3,46.14,"protein_coding","protein_coding",23868,23868
"ENSG00000186980","ENST00000334160",21,30348399,30348609,-1,30348399,30348609,"KRTAP23-1",1,56.4,"protein_coding","protein_coding",210,210
"ENSG00000250973","ENST00000508999",21,30356515,30356885,-1,30356515,30356885,"KRTAP13-6P",1,46.09,"unprocessed_pseudogene","unprocessed_pseudogene",370,370
"ENSG00000225431","ENST00000419628",21,42599280,42615058,-1,42599280,42615058,"AP001626.1",1,45.07,"lincRNA","lincRNA",15778,15778
"ENSG00000227075","ENST00000452500",21,21933315,21975681,-1,21933315,21975681,"AP000472.3",1,34.79,"lincRNA","lincRNA",42366,42366
"ENSG00000279669","ENST00000623753",21,5232668,5243833,-1,5232668,5243833,"RP11-717F1.1",1,39.71,"lincRNA","lincRNA",11165,11165
"ENSG00000241837","ENST00000290299",21,33903453,33915980,-1,33903453,33915980,"ATP5O",10,43.51,"protein_coding","protein_coding",12527,12527
"ENSG00000233213","ENST00000435001",21,37717102,37719569,-1,37717102,37719569,"KCNJ6-AS1",1,48.1,"sense_intronic","sense_intronic",2467,2467
"ENSG00000279751","ENST00000623720",21,6904884,6906692,1,6904884,6906692,"CH507-210P18.5",1,37.26,"lincRNA","lincRNA",1808,1808
"ENSG00000228120","ENST00000433840",21,43159066,43162277,-1,43159066,43162277,"AP001631.10",1,60.4,"lincRNA","lincRNA",3211,3211
"ENSG00000223262","ENST00000411330",21,42221173,42221286,1,42221173,42221286,"RNA5SP492",1,52.63,"rRNA","rRNA",113,113
"ENSG00000240755","ENST00000433806",21,14143581,14144158,1,14143581,14144158,"ERLEC1P1",1,38.06,"processed_pseudogene","processed_pseudogene",577,577
"ENSG00000224905","ENST00000428809",21,14027421,14144468,1,14027421,14144468,"AP001347.6",3,42.94,"antisense","antisense",117047,117047
"ENSG00000233056","ENST00000447535",21,42916803,42925646,-1,42916803,42925646,"ERVH48-1",2,50.59,"lincRNA","lincRNA",8843,8843
"ENSG00000225555","ENST00000440403",21,34370802,34375348,-1,34370802,34375348,"AP000320.6",1,45.28,"antisense","antisense",4546,4546
"ENSG00000276556","ENST00000611755",21,10640028,10640338,-1,10640028,10640338,"AF254982.2",1,52.73,"unprocessed_pseudogene","unprocessed_pseudogene",310,310
"ENSG00000224574","ENST00000446475",21,45407386,45410065,-1,45407386,45410065,"COL18A1-AS2",1,59.78,"antisense","antisense",2679,2679
"ENSG00000224141","ENST00000437492",21,18561265,18760003,-1,18561265,18760003,"MIR548XHG",3,35.53,"lincRNA","lincRNA",198738,198738
"ENSG00000231136","ENST00000454567",21,22153950,22154299,-1,22153950,22154299,"AP000705.6",1,52.57,"processed_pseudogene","processed_pseudogene",349,349
"ENSG00000272958","ENST00000608289",21,34425508,34426017,1,34425508,34426017,"CMP21-97G8.2",1,38.24,"lincRNA","lincRNA",509,509
"ENSG00000234030","ENST00000452969",21,43783123,43783573,1,43783123,43783573,"TMEM97P1",1,52.77,"processed_pseudogene","processed_pseudogene",450,450
"ENSG00000154646","ENST00000284885",21,18269116,18485879,-1,18269116,18403656,"TMPRSS15",3,35.11,"protein_coding","protein_coding",216763,134540
"ENSG00000237373","ENST00000435608",21,39217093,39219805,-1,39217093,39219805,"BRWD1-IT1",1,37.38,"sense_overlapping","sense_overlapping",2712,2712
"ENSG00000272991","ENST00000608767",21,39184469,39184899,1,39184469,39184899,"AF129408.17",1,34.57,"antisense","antisense",430,430
"ENSG00000280346","ENST00000624353",21,6507017,6507389,-1,6507017,6507389,"CH507-152C13.4",1,46.11,"processed_pseudogene","processed_pseudogene",372,372
"ENSG00000279094","ENST00000624261",21,5499151,5502542,-1,5499151,5502542,"CH507-24F1.1",3,38.09,"lincRNA","lincRNA",3391,3391
"ENSG00000272948","ENST00000608405",21,37267784,37268497,1,37267784,37268497,"AP001412.1",1,57.28,"antisense","antisense",713,713
"ENSG00000155307","ENST00000285670",21,14485228,14583402,-1,14485228,14583402,"SAMSN1",6,36.18,"protein_coding","protein_coding",98174,98174
"ENSG00000237444","ENST00000423389",21,25031005,25031529,-1,25031005,25031529,"AP001342.1",1,39.43,"processed_pseudogene","processed_pseudogene",524,524
"ENSG00000230379","ENST00000444178",21,24938431,24992817,-1,24938431,24992817,"AP000146.2",3,36.8,"lincRNA","lincRNA",54386,54386
"ENSG00000226983","ENST00000441009",21,24840550,25057746,1,24840550,25057746,"AP000235.2",1,36.08,"lincRNA","lincRNA",217196,217196
"ENSG00000227090","ENST00000446404",21,24886676,24902756,-1,24886676,24902756,"AP000402.3",1,34.21,"lincRNA","lincRNA",16080,16080
"ENSG00000244278","ENST00000424017",21,25055535,25069906,1,25055535,25069906,"AP000235.3",1,36.36,"lincRNA","lincRNA",14371,14371
"ENSG00000231324","ENST00000457669",21,36632681,36637033,-1,36632681,36637033,"AP000696.2",1,43.4,"lincRNA","lincRNA",4352,4352
"ENSG00000232260","ENST00000413813",21,17518526,17518993,-1,17518526,17518993,"BTF3L4P1",1,41.67,"processed_pseudogene","processed_pseudogene",467,467
"ENSG00000160200","ENST00000352178",21,43053191,43076943,-1,43053191,43076378,"CBS",17,59.18,"protein_coding","protein_coding",23752,23187
"ENSG00000174680","ENST00000455392",21,29748175,29764002,1,29748175,29763680,"GRIK1-AS1",5,40.42,"antisense","antisense",15827,15505
"ENSG00000237646","ENST00000434195",21,36803984,36806284,-1,36803984,36806284,"HLCS-IT1",1,47.81,"sense_intronic","sense_intronic",2300,2300
"ENSG00000224790","ENST00000637940",21,36966492,36975164,1,36966492,36975164,"AP000704.5",2,47.75,"lincRNA","lincRNA",8672,8672
"ENSG00000236663","ENST00000424933",21,43140523,43141092,-1,43140523,43141092,"FRGCA",1,56.84,"antisense","antisense",569,569
"ENSG00000225218","ENST00000431150",21,42831040,42836477,-1,42831040,42836477,"AP001628.6",1,51.1,"lincRNA","lincRNA",5437,5437
"ENSG00000160209","ENST00000468090",21,43719094,43762307,1,43719097,43762307,"PDXK",19,57.26,"protein_coding","protein_coding",43213,43210
"ENSG00000236119","ENST00000445464",21,36082859,36090414,1,36082859,36090414,"AP000688.15",1,43.36,"lincRNA","lincRNA",7555,7555
"ENSG00000233393","ENST00000422473",21,36104881,36109690,1,36104881,36109690,"AP000688.29",1,42.04,"lincRNA","lincRNA",4809,4809
"ENSG00000159228","ENST00000530908",21,36069941,36073166,1,36069941,36073166,"CBR1",5,50.62,"protein_coding","protein_coding",3225,3225
"ENSG00000224269","ENST00000430607",21,36698773,36701564,-1,36698773,36701564,"AP000697.6",1,67.73,"antisense","antisense",2791,2791
"ENSG00000224247","ENST00000433588",21,15493932,15496124,-1,15493932,15496124,"AJ009632.3",1,39.99,"lincRNA","lincRNA",2192,2192
"ENSG00000159263","ENST00000290399",21,36699133,36749917,1,36699134,36749917,"SIM2",5,51.13,"protein_coding","protein_coding",50784,50783
"ENSG00000198862","ENST00000614971",21,28928144,28992956,-1,28928144,28992956,"LTN1",7,36.74,"protein_coding","protein_coding",64812,64812
"ENSG00000160305","ENST00000400274",21,46458899,46569852,1,46458899,46569708,"DIP2A",12,44.91,"protein_coding","protein_coding",110953,110809
"ENSG00000228318","ENST00000411427",21,41441056,41445708,-1,41441056,41445708,"AP001610.5",1,45.37,"antisense","antisense",4652,4652
"ENSG00000273614","ENST00000619030",21,7826098,7826225,-1,7826098,7826225,"SNORA11",1,57.03,"snoRNA","snoRNA",127,127
"ENSG00000212564","ENST00000391262",21,15614283,15614389,1,15614283,15614389,"RNU6-1326P",1,41.12,"snRNA","snRNA",106,106
"ENSG00000184012","ENST00000454499",21,41464551,41531116,-1,41467734,41531116,"TMPRSS2",11,49.1,"protein_coding","protein_coding",66565,63382
"ENSG00000274276","ENST00000618024",21,6444869,6468040,-1,6444869,6468040,"CBSL",10,58.81,"protein_coding","protein_coding",23171,23171
"ENSG00000229025","ENST00000435878",21,26349780,26350634,-1,26349780,26350634,"AP001595.1",1,38.36,"lincRNA","lincRNA",854,854
"ENSG00000166979","ENST00000300255",21,32412006,32515397,1,32412381,32515389,"EVA1C",13,46.51,"protein_coding","protein_coding",103391,103008
"ENSG00000275874","ENST00000615826",21,44999208,45004727,-1,44999208,45004727,"PICSAR",1,62.75,"lincRNA","lincRNA",5519,5519
"ENSG00000236830","ENST00000624080",21,36131767,36175815,-1,36132800,36175815,"CBR3-AS1",18,47.9,"processed_transcript","antisense",44048,43015
"ENSG00000231355","ENST00000450928",21,33482499,33484258,-1,33482499,33484258,"AP000302.58",1,43.58,"antisense","antisense",1759,1759
"ENSG00000235277","ENST00000430391",21,14918534,14947096,1,14918534,14947096,"AF127577.8",1,38.85,"antisense","antisense",28562,28562
"ENSG00000223400","ENST00000418874",21,41576135,41581319,-1,41576135,41581319,"AP006748.1",1,40.73,"lincRNA","lincRNA",5184,5184
"ENSG00000229047","ENST00000446301",21,14961309,14964233,1,14961309,14964233,"AF127577.10",1,32.85,"antisense","antisense",2924,2924
"ENSG00000180530","ENST00000400202",21,14961235,15065936,-1,14961235,15065000,"NRIP1",7,36.59,"protein_coding","protein_coding",104701,103765
"ENSG00000230233","ENST00000416002",21,18614431,18650360,1,18614431,18650360,"AF240627.2",1,33.26,"lincRNA","lincRNA",35929,35929
"ENSG00000235965","ENST00000450653",21,19046310,19047684,-1,19046310,19047684,"AP000431.1",1,33.45,"lincRNA","lincRNA",1374,1374
"ENSG00000275166","ENST00000622292",21,41746772,41746841,-1,41746772,41746841,"MIR6814",1,62.86,"miRNA","miRNA",69,69
"ENSG00000279226","ENST00000623061",21,6520344,6520670,-1,6520344,6520670,"CH507-152C13.5",1,48.01,"TEC","TEC",326,326
"ENSG00000278927","ENST00000623896",21,6550749,6553955,-1,6550749,6553955,"CH507-152C13.6",1,60.46,"lincRNA","lincRNA",3206,3206
"ENSG00000154723","ENST00000400099",21,25716503,25735673,-1,25716503,25735027,"ATP5J",8,41.96,"protein_coding","protein_coding",19170,18524
"ENSG00000157557","ENST00000360214",21,38805307,38824955,1,38805307,38824955,"ETS2",4,46.04,"protein_coding","protein_coding",19648,19648
"ENSG00000237569","ENST00000425085",21,23407658,23409128,-1,23407658,23409128,"TUBAP",1,46.97,"processed_pseudogene","processed_pseudogene",1470,1470
"ENSG00000251851","ENST00000516042",21,20355748,20355852,-1,20355748,20355852,"RNU6-772P",1,31.43,"snRNA","snRNA",104,104
"ENSG00000280330","ENST00000624153",21,7129103,7130287,1,7129103,7130287,"CH507-236L23.2",1,56.12,"processed_pseudogene","processed_pseudogene",1184,1184
"ENSG00000279303","ENST00000623962",21,7135334,7137789,-1,7135334,7137789,"CH507-236L23.3",1,35.67,"TEC","TEC",2455,2455
"ENSG00000274662","ENST00000410635",21,25101132,25101415,1,25101132,25101415,"RN7SKP236",1,51.76,"misc_RNA","misc_RNA",283,283
"ENSG00000215317","ENST00000400014",21,28901779,28903697,-1,28901779,28903697,"THUMPD1P1",1,47.11,"processed_pseudogene","processed_pseudogene",1918,1918
"ENSG00000207416","ENST00000384685",21,36986739,36986851,-1,36986739,36986851,"Y_RNA",1,37.17,"misc_RNA","misc_RNA",112,112
"ENSG00000275950","ENST00000616420",21,8205315,8205406,1,8205315,8205406,"MIR6724-1",1,83.7,"miRNA","miRNA",91,91
"ENSG00000236883","ENST00000423276",21,41739373,41741308,1,41739373,41741308,"AP001615.9",1,53.62,"antisense","antisense",1935,1935
"ENSG00000276289","ENST00000622690",21,7816675,7829926,-1,7816675,7829926,"KCNE1B",4,48.09,"protein_coding","protein_coding",13251,13251
"ENSG00000183421","ENST00000332512",21,41739369,41767106,-1,41739369,41767106,"RIPK4",2,53.5,"protein_coding","protein_coding",27737,27737
"ENSG00000231755","ENST00000447175",21,17835016,17885608,-1,17835016,17885608,"CHODL-AS1",1,38.64,"lincRNA","lincRNA",50592,50592
"ENSG00000233997","ENST00000425979",21,21746973,21797415,1,21746973,21797415,"LINC01425",2,35.45,"lincRNA","lincRNA",50442,50442
"ENSG00000180509","ENST00000337385",21,34446688,34512275,-1,34446688,34511339,"KCNE1",9,43.71,"protein_coding","protein_coding",65587,64651
"ENSG00000159200","ENST00000313806",21,34513142,34615142,-1,34516484,34615142,"RCAN1",14,44.24,"protein_coding","protein_coding",102000,98658
"ENSG00000273017","ENST00000609910",21,29359002,29359453,1,29359002,29359453,"AP000240.9",1,27.88,"sense_intronic","sense_intronic",451,451
"ENSG00000226406","ENST00000454795",21,14829154,14829989,-1,14829154,14829989,"RBMX2P1",1,46.89,"processed_pseudogene","processed_pseudogene",835,835
"ENSG00000279390","ENST00000623352",21,15050189,15052379,1,15050189,15052379,"AF127577.13",1,39.89,"TEC","TEC",2190,2190
"ENSG00000231201","ENST00000436429",21,14971470,14992854,1,14971470,14992854,"AF127577.11",1,36.29,"antisense","antisense",21384,21384
"ENSG00000187172","ENST00000470054",21,10413477,10516431,1,10413532,10491615,"BAGE2",3,37.59,"transcribed_unprocessed_pseudogene","processed_transcript",102954,78083
"ENSG00000235609","ENST00000432230",21,14818843,15014430,-1,14818843,15014430,"AF127936.9",1,37.71,"lincRNA","lincRNA",195587,195587
"ENSG00000281903","ENST00000625278",21,14819699,14918552,-1,14824327,14918552,"AF127936.7",7,38.04,"lincRNA","lincRNA",98853,94225
"ENSG00000235564","ENST00000447405",21,23960905,23967273,-1,23960905,23967273,"AP000477.2",1,45.96,"lincRNA","lincRNA",6368,6368
"ENSG00000276612","ENST00000623476",21,5116343,5133805,-1,5116343,5133805,"CH507-9B2.4",1,57.86,"protein_coding","protein_coding",17462,17462
"ENSG00000223563","ENST00000426771",21,26889376,26939742,1,26889376,26939742,"AP001601.2",1,36.94,"antisense","antisense",50366,50366
"ENSG00000279647","ENST00000624595",21,7385058,7388799,-1,7385058,7388799,"CH507-254M2.5",1,53.71,"unprocessed_pseudogene","unprocessed_pseudogene",3741,3741
"ENSG00000228349","ENST00000431743",21,39491544,39491898,-1,39491544,39491898,"RPS26P4",1,45.63,"processed_pseudogene","processed_pseudogene",354,354
"ENSG00000231713","ENST00000457325",21,39727755,39730680,1,39727755,39730680,"AF064860.7",2,46.21,"lincRNA","lincRNA",2925,2925
"ENSG00000206102","ENST00000382822",21,31038159,31038476,-1,31038159,31038476,"KRTAP19-8",1,49.06,"protein_coding","protein_coding",317,317
"ENSG00000214867","ENST00000399149",21,36295173,36295702,-1,36295173,36295702,"SRSF9P1",1,56.04,"processed_pseudogene","processed_pseudogene",529,529
"ENSG00000159197","ENST00000290310",21,34364024,34371389,1,34364024,34371389,"KCNE2",1,43.25,"protein_coding","protein_coding",7365,7365
"ENSG00000205930","ENST00000454365",21,32772100,32893735,1,32772150,32893735,"C21orf62-AS1",7,42.17,"antisense","antisense",121635,121585
"ENSG00000229356","ENST00000426578",21,44450986,44455284,-1,44450986,44455284,"LRRC3-AS1",1,43.64,"antisense","antisense",4298,4298
"ENSG00000157540","ENST00000338785",21,37365790,37517450,1,37367577,37515377,"DYRK1A",9,38.86,"protein_coding","protein_coding",151660,147800
"ENSG00000243440","ENST00000400562",21,14591930,14658821,-1,14593720,14658821,"AF165138.7",4,36.85,"protein_coding","protein_coding",66891,65101
"ENSG00000273796","ENST00000617004",21,45403809,45404369,-1,45403809,45404369,"LL21NC02-21A1.1",1,59.71,"lincRNA","lincRNA",560,560
"ENSG00000278932","ENST00000622961",21,9325013,9368775,1,9325013,9368775,"bP-21264C1.2",6,43.43,"lincRNA","lincRNA",43762,43762
"ENSG00000183255","ENST00000445724",21,44849585,44873903,-1,44849586,44873903,"PTTG1IP",7,51,"protein_coding","protein_coding",24318,24317
"ENSG00000160180","ENST00000518498",21,42311667,42315651,-1,42311667,42315651,"TFF3",4,54.43,"protein_coding","protein_coding",3984,3984
"ENSG00000232560","ENST00000440664",21,17438890,17449185,1,17438890,17449185,"LINC01549",2,39.57,"lincRNA","lincRNA",10295,10295
"ENSG00000273464","ENST00000608759",21,29657406,29657831,1,29657406,29657831,"RP11-313P22.1",1,41.08,"antisense","antisense",425,425
"ENSG00000279718","ENST00000624821",21,9364467,9365225,-1,9364467,9365225,"SNX18P12",1,49.54,"processed_pseudogene","processed_pseudogene",758,758
"ENSG00000279211","ENST00000623408",21,9580024,9580415,-1,9580024,9580415,"RP11-570J4.2",1,60.46,"processed_pseudogene","processed_pseudogene",391,391
"ENSG00000225267","ENST00000430538",21,30263380,30263881,-1,30263380,30263881,"RPL8P2",1,55.18,"processed_pseudogene","processed_pseudogene",501,501
"ENSG00000277379","ENST00000622482",21,8388362,8388453,1,8388362,8388453,"MIR6724-3",1,83.7,"miRNA","miRNA",91,91
"ENSG00000278931","ENST00000624291",21,8857260,8880976,1,8857260,8880976,"bP-2189O9.2",1,35.46,"unprocessed_pseudogene","unprocessed_pseudogene",23716,23716
"ENSG00000154719","ENST00000352957",21,25585656,25607517,-1,25585656,25607517,"MRPL39",3,37.94,"protein_coding","protein_coding",21861,21861
"ENSG00000157601","ENST00000398600",21,41420304,41459214,1,41420515,41459214,"MX1",18,47.01,"protein_coding","protein_coding",38910,38699
"ENSG00000278678","ENST00000616920",21,10576292,10576587,1,10576292,10576587,"CYCSP41",1,43.58,"processed_pseudogene","processed_pseudogene",295,295
"ENSG00000207476","ENST00000384745",21,13621577,13621683,1,13621577,13621683,"RNU6-286P",1,43.93,"snRNA","snRNA",106,106
"ENSG00000186924","ENST00000334680",21,30601087,30601382,1,30601087,30601382,"KRTAP22-1",1,45.27,"protein_coding","protein_coding",295,295
"ENSG00000274391","ENST00000622113",21,10521553,10606140,1,10521553,10606140,"TPTE",5,38.91,"protein_coding","protein_coding",84587,84587
"ENSG00000160179","ENST00000398457",21,42199689,42297244,1,42199689,42297244,"ABCG1",11,51.02,"protein_coding","protein_coding",97555,97555
"ENSG00000156299","ENST00000286827",21,31118416,31559977,-1,31118416,31558977,"TIAM1",7,43.86,"protein_coding","protein_coding",441561,440561
"ENSG00000166351","ENST00000299443",21,13609858,13641585,1,13610177,13641585,"POTED",2,36.71,"protein_coding","protein_coding",31727,31408
"ENSG00000142156","ENST00000361866",21,45981737,46005050,1,45981737,46005050,"COL6A1",7,64.67,"protein_coding","protein_coding",23313,23313
"ENSG00000227840","ENST00000423658",21,30806932,30807119,-1,30806932,30807119,"KRTAP8-3P",1,49.47,"unprocessed_pseudogene","unprocessed_pseudogene",187,187
"ENSG00000223671","ENST00000421454",21,35472095,35472432,-1,35472095,35472432,"RPL34P3",1,41.72,"processed_pseudogene","processed_pseudogene",337,337
"ENSG00000234703","ENST00000455028",21,35136638,35139222,1,35136638,35139222,"AF015262.2",1,45.84,"lincRNA","lincRNA",2584,2584
"ENSG00000242220","ENST00000300258",21,32574841,32587373,-1,32574841,32585533,"TCP10L",4,50.2,"protein_coding","protein_coding",12532,10692
"ENSG00000280109","ENST00000624999",21,41175231,41185239,-1,41175231,41185239,"PLAC4",2,46.2,"TEC","TEC",10008,10008
"ENSG00000224524","ENST00000450823",21,15490530,15490767,-1,15490530,15490767,"CYCSP42",1,44.96,"processed_pseudogene","processed_pseudogene",237,237
"ENSG00000224860","ENST00000433312",21,13824406,13825635,-1,13824406,13825635,"GXYLT1P2",1,42.36,"processed_pseudogene","processed_pseudogene",1229,1229
"ENSG00000160233","ENST00000291592",21,44455486,44462196,1,44455486,44462196,"LRRC3",1,61.26,"protein_coding","protein_coding",6710,6710
"ENSG00000184856","ENST00000419431",21,22098617,22116528,1,22098617,22116528,"LINC00308",1,34.5,"lincRNA","lincRNA",17911,17911
"ENSG00000157542","ENST00000609713",21,37607376,37916446,-1,37607376,37916446,"KCNJ6",1,43.67,"protein_coding","protein_coding",309070,309070
"ENSG00000215088","ENST00000414617",21,33481580,33482195,-1,33481580,33482195,"RPS5P3",1,54.87,"processed_pseudogene","processed_pseudogene",615,615
"ENSG00000183570","ENST00000400314",21,45643694,45942454,1,45643694,45942454,"PCBP3",21,46.92,"protein_coding","protein_coding",298760,298760
"ENSG00000229925","ENST00000434589",21,38888772,38903905,1,38888772,38903905,"AP001043.1",1,38.3,"lincRNA","lincRNA",15133,15133
"ENSG00000243489","ENST00000334670",21,44646414,44647650,1,44646414,44647650,"KRTAP10-11",1,62.41,"protein_coding","protein_coding",1236,1236
"ENSG00000183145","ENST00000485272",21,37006150,37019659,1,37006150,37019659,"RIPPLY3",3,48.79,"protein_coding","processed_transcript",13509,13509
"ENSG00000184441","ENST00000448927",21,44331234,44335851,1,44331234,44335851,"AP001062.7",1,61.76,"antisense","antisense",4617,4617
"ENSG00000160191","ENST00000335512",21,42653636,42775509,1,42653750,42775509,"PDE9A",28,51.29,"protein_coding","protein_coding",121873,121759
"ENSG00000186866","ENST00000331343",21,45263928,45287898,-1,45263928,45287898,"POFUT2",14,52.95,"protein_coding","protein_coding",23970,23970
"ENSG00000215458","ENST00000400385",21,43805758,43812567,-1,43805758,43812567,"AATBC",3,60.18,"antisense","antisense",6809,6809
"ENSG00000223287","ENST00000411355",21,13968489,13968595,-1,13968489,13968595,"RNU6-954P",1,40.19,"snRNA","snRNA",106,106
"ENSG00000202339","ENST00000365469",21,22205192,22205332,1,22205192,22205332,"RNU4-45P",1,42.55,"snRNA","snRNA",140,140
"ENSG00000280436","ENST00000623201",21,9053122,9059060,1,9053122,9059060,"bP-2171C21.2",1,38.95,"unprocessed_pseudogene","unprocessed_pseudogene",5938,5938
"ENSG00000223975","ENST00000436359",21,43465309,43467298,1,43465309,43467298,"AP001048.4",1,50.55,"lincRNA","lincRNA",1989,1989
"ENSG00000277352","ENST00000622854",21,44494874,44495519,1,44494874,44495519,"KB-68A7.2",1,51.08,"lincRNA","lincRNA",645,645
"ENSG00000270093","ENST00000602659",21,16643529,16645065,1,16643529,16645065,"AP000473.8",1,37.8,"lincRNA","lincRNA",1536,1536
"ENSG00000154721","ENST00000480456",21,25639272,25717562,1,25639272,25717562,"JAM2",7,39.65,"protein_coding","protein_coding",78290,78290
"ENSG00000256073","ENST00000534991",21,32393130,32393960,1,32393130,32393960,"URB1-AS1",1,54.63,"lincRNA","lincRNA",830,830
"ENSG00000266299","ENST00000581787",21,13644775,13644850,-1,13644775,13644850,"MIR3118-1",1,32.89,"miRNA","miRNA",75,75
"ENSG00000273115","ENST00000608410",21,26459903,26460214,-1,26459903,26460214,"KB-1466C5.1",1,42.95,"lincRNA","lincRNA",311,311
"ENSG00000228355","ENST00000456613",21,45378201,45379635,-1,45378201,45379624,"BX322559.3",2,57,"antisense","antisense",1434,1423
"ENSG00000243064","ENST00000463099",21,14236206,14362754,1,14274092,14362754,"ABCC13",6,36.49,"transcribed_unprocessed_pseudogene","transcribed_unprocessed_pseudogene",126548,88662
"ENSG00000233922","ENST00000441095",21,45593654,45603056,1,45593654,45603056,"AL133493.2",2,52.25,"lincRNA","lincRNA",9402,9402
"ENSG00000235514","ENST00000436405",21,25762938,25763333,-1,25762938,25763333,"LLPHP2",1,39.9,"processed_pseudogene","processed_pseudogene",395,395
"ENSG00000199806","ENST00000362936",21,36851911,36852028,1,36851911,36852028,"RNA5SP491",1,61.02,"rRNA","rRNA",117,117
"ENSG00000244294","ENST00000467060",21,33918995,33919338,-1,33918995,33919338,"RN7SL740P",1,53.49,"misc_RNA","misc_RNA",343,343
"ENSG00000223806","ENST00000429621",21,38739021,38747460,-1,38739021,38747460,"LINC00114",3,41.69,"lincRNA","lincRNA",8439,8439
"ENSG00000183249","ENST00000457709",21,14000927,14005279,1,14000927,14005279,"NF1P3",1,36.34,"unprocessed_pseudogene","unprocessed_pseudogene",4352,4352
"ENSG00000227330","ENST00000432412",21,18022370,18114904,-1,18022370,18114904,"AP000998.2",1,36.93,"lincRNA","lincRNA",92534,92534
"ENSG00000142182","ENST00000270172",21,44246339,44262216,-1,44246339,44262216,"DNMT3L",4,57,"protein_coding","protein_coding",15877,15877
"ENSG00000205439","ENST00000619249",21,44646657,44658341,1,44646657,44658270,"KRTAP12-3",2,53.88,"protein_coding","protein_coding",11684,11613
"ENSG00000205424","ENST00000380008",21,45827961,45836419,-1,45827961,45836419,"AL592528.1",1,56.07,"antisense","antisense",8458,8458
"ENSG00000177398","ENST00000400424",21,42062959,42143453,1,42062959,42143453,"UMODL1",14,52.21,"protein_coding","protein_coding",80494,80494
"ENSG00000187005","ENST00000335093",21,30754830,30755428,-1,30754830,30755428,"KRTAP21-1",1,43.91,"protein_coding","protein_coding",598,598
"ENSG00000278381","ENST00000613704",21,13654073,13654356,1,13654073,13654356,"AL050303.11",1,31.69,"processed_pseudogene","processed_pseudogene",283,283
"ENSG00000227874","ENST00000435181",21,13665868,13667546,-1,13665868,13667546,"GRAMD4P1",1,54.02,"processed_pseudogene","processed_pseudogene",1678,1678
"ENSG00000239415","ENST00000430259",21,46251549,46254133,-1,46251812,46254133,"AP001469.9",2,44.14,"antisense","antisense",2584,2321
"ENSG00000215424","ENST00000590829",21,46229217,46259390,1,46229217,46259390,"MCM3AP-AS1",9,46.48,"antisense","antisense",30173,30173
"ENSG00000279851","ENST00000623370",21,10122273,10129029,1,10122273,10129029,"CH507-216K13.2",1,58.47,"lincRNA","lincRNA",6756,6756
"ENSG00000159231","ENST00000290354",21,36134912,36146566,1,36134912,36146566,"CBR3",1,48.69,"protein_coding","protein_coding",11654,11654
"ENSG00000232512","ENST00000453802",21,25095022,25103670,1,25095022,25103670,"AP000233.2",2,35.82,"lincRNA","lincRNA",8648,8648
"ENSG00000186842","ENST00000334165",21,32572238,32575881,-1,32572238,32575881,"LINC00846",1,50.6,"3prime_overlapping_ncRNA","3prime_overlapping_ncRNA",3643,3643
"ENSG00000276076","ENST00000619537",21,6560714,6564489,1,6560714,6564489,"CH507-152C13.3",4,63.03,"protein_coding","protein_coding",3775,3775
"ENSG00000228861","ENST00000467573",21,39127568,39128040,1,39127568,39128040,"RPL23AP12",1,47.99,"processed_pseudogene","processed_pseudogene",472,472
"ENSG00000275170","ENST00000613317",21,14019060,14020725,-1,14019060,14020725,"FRG2MP",1,46.64,"processed_pseudogene","processed_pseudogene",1665,1665
"ENSG00000265590","ENST00000553001",21,32578822,32612281,-1,32578823,32612281,"AP000275.65",2,47.45,"protein_coding","protein_coding",33459,33458
"ENSG00000235701","ENST00000437262",21,39171130,39172106,-1,39171130,39172106,"PCBP2P1",1,49.54,"processed_pseudogene","processed_pseudogene",976,976
"ENSG00000280095","ENST00000623983",21,6081193,6082585,1,6081193,6082585,"CH507-42P11.7",1,59.37,"lincRNA","lincRNA",1392,1392
"ENSG00000231106","ENST00000457157",21,36005338,36007838,1,36005338,36007838,"LINC01436",1,46.9,"lincRNA","lincRNA",2500,2500
"ENSG00000215447","ENST00000400362",21,45288052,45291738,1,45288062,45291738,"BX322557.10",2,53.84,"processed_transcript","lincRNA",3686,3676
"ENSG00000154639","ENST00000400169",21,17512382,17593579,1,17513130,17593579,"CXADR",5,40.2,"protein_coding","protein_coding",81197,80449
"ENSG00000277991","ENST00000623374",21,7669397,7681742,-1,7669397,7679177,"CH507-338C24.1",8,39.72,"lincRNA","lincRNA",12345,9780
"ENSG00000228137","ENST00000444966",21,46246890,46247682,1,46246890,46247682,"AP001469.7",1,45.65,"antisense","antisense",792,792
"ENSG00000252619","ENST00000516810",21,42417497,42417593,-1,42417497,42417593,"RNU6-1149P",1,31.96,"snRNA","snRNA",96,96
"ENSG00000223768","ENST00000433465",21,45293285,45297354,1,45293285,45297354,"LINC00205",1,51.62,"lincRNA","lincRNA",4069,4069
"ENSG00000188155","ENST00000622352",21,44579796,44592505,-1,44579796,44592469,"KRTAP10-6",2,48.43,"protein_coding","protein_coding",12709,12673
"ENSG00000156256","ENST00000399975",21,29024629,29054488,1,29024629,29054488,"USP16",6,38.76,"protein_coding","protein_coding",29859,29859
"ENSG00000241123","ENST00000400372",21,44579455,44580604,-1,44579455,44580604,"KRTAP10-5",1,65.91,"protein_coding","protein_coding",1149,1149
"ENSG00000236382","ENST00000412914",21,44702221,44702791,1,44702221,44702791,"KRTAP10-13P",1,67.78,"unprocessed_pseudogene","unprocessed_pseudogene",570,570
"ENSG00000215454","ENST00000400374",21,44573729,44575371,1,44573729,44575371,"KRTAP10-4",1,63.97,"protein_coding","protein_coding",1642,1642
"ENSG00000281420","ENST00000626421",21,43748365,43748468,-1,43748365,43748468,"AP001052.1",1,60.58,"pseudogene","pseudogene",103,103
"ENSG00000185390","ENST00000332473",21,13349265,13350648,1,13349265,13350648,"FGF7P2",1,32.8,"unprocessed_pseudogene","unprocessed_pseudogene",1383,1383
"ENSG00000221859","ENST00000380095",21,44637356,44638455,1,44637356,44638455,"KRTAP10-10",1,64.18,"protein_coding","protein_coding",1099,1099
"ENSG00000160194","ENST00000460259",21,42879644,42913304,1,42879644,42909105,"NDUFV3",4,46.83,"protein_coding","processed_transcript",33660,29461
"ENSG00000232623","ENST00000450936",21,32306464,32308737,-1,32306464,32308737,"AP000266.7",1,48.46,"antisense","antisense",2273,2273
"ENSG00000230870","ENST00000393804",21,31627127,31628600,-1,31627127,31628600,"FBXW11P1",1,44.37,"processed_pseudogene","processed_pseudogene",1473,1473
"ENSG00000205726","ENST00000381318",21,33642400,33899861,1,33642458,33899861,"ITSN1",32,42.47,"protein_coding","protein_coding",257461,257403
"ENSG00000197381","ENST00000389861",21,45073853,45226560,1,45074600,45226560,"ADARB1",15,45.43,"protein_coding","processed_transcript",152707,151960
"ENSG00000273590","ENST00000623661",21,7744962,7777853,1,7748899,7777853,"SMIM11B",7,47.23,"protein_coding","protein_coding",32891,28954
"ENSG00000214319","ENST00000398098",21,13676022,13677116,1,13676022,13677116,"CXADRP1",1,42.83,"processed_pseudogene","processed_pseudogene",1094,1094
"ENSG00000215353","ENST00000400117",21,19759359,19760128,-1,19759359,19760128,"C1QBPP1",1,54.29,"processed_pseudogene","processed_pseudogene",769,769
"ENSG00000279773","ENST00000624520",21,13679300,13681138,-1,13679300,13681138,"AL050303.10",1,63.19,"TEC","TEC",1838,1838
"ENSG00000233316","ENST00000432141",21,38206156,38208644,1,38206156,38208644,"DSCR10",2,53.48,"sense_intronic","sense_intronic",2488,2488
"ENSG00000271486","ENST00000603349",21,19620695,19621545,1,19620695,19621545,"AP000403.3",1,34.31,"processed_pseudogene","processed_pseudogene",850,850
"ENSG00000273692","ENST00000619798",21,13704853,13705518,1,13704853,13705518,"AL050303.12",1,74.92,"processed_pseudogene","processed_pseudogene",665,665
"ENSG00000159256","ENST00000400485",21,36320189,36386148,1,36320189,36376646,"MORC3",12,42.3,"protein_coding","protein_coding",65959,56457
"ENSG00000233480","ENST00000443479",21,19893279,19899755,-1,19893279,19899755,"AP000946.2",1,35.19,"lincRNA","lincRNA",6476,6476
"ENSG00000226771","ENST00000425058",21,21223295,21226829,-1,21223295,21226829,"AP001136.2",1,33.66,"antisense","antisense",3534,3534
"ENSG00000274333","ENST00000623914",21,5553637,5614880,1,5553703,5614880,"RP11-717F1.2",13,40.97,"lincRNA","lincRNA",61243,61177
"ENSG00000159131","ENST00000424203",21,33503931,33543491,-1,33503933,33542892,"GART",18,41.63,"protein_coding","nonsense_mediated_decay",39560,38959
"ENSG00000233236","ENST00000436373",21,20256752,20258820,-1,20256752,20258820,"AP001171.1",1,37.75,"lincRNA","lincRNA",2068,2068
"ENSG00000233676","ENST00000425091",21,20388334,20388845,1,20388334,20388845,"FDPSP6",1,51.95,"processed_pseudogene","processed_pseudogene",511,511
"ENSG00000234439","ENST00000447938",21,20424949,20426206,-1,20424949,20426206,"KRT18P2",1,55.01,"processed_pseudogene","processed_pseudogene",1257,1257
"ENSG00000226956","ENST00000416641",21,17659276,17660384,-1,17659276,17660384,"AP000432.2",1,41.75,"lincRNA","lincRNA",1108,1108
"ENSG00000279648","ENST00000624164",21,17705408,17707455,1,17705408,17707455,"AP000432.3",1,37.01,"TEC","TEC",2047,2047
"ENSG00000177692","ENST00000617313",21,33485530,33491720,-1,33485530,33491473,"DNAJC28",4,44.63,"protein_coding","protein_coding",6190,5943
"ENSG00000229231","ENST00000431297",21,13762338,13764332,1,13762338,13764332,"FEM1AP1",1,63.66,"processed_pseudogene","processed_pseudogene",1994,1994
"ENSG00000224922","ENST00000444356",21,13769932,13771740,1,13769932,13771740,"AL050303.7",1,37.31,"lincRNA","lincRNA",1808,1808
"ENSG00000188992","ENST00000536861",21,14108813,14210891,-1,14108893,14210891,"LIPI",4,35.86,"protein_coding","protein_coding",102078,101998
"ENSG00000229986","ENST00000416842",21,38846247,38848644,1,38846247,38848644,"AP001042.1",1,39.91,"lincRNA","lincRNA",2397,2397
"ENSG00000228941","ENST00000429033",21,31060600,31063168,-1,31060600,31063168,"UBE3AP2",1,40.33,"processed_pseudogene","processed_pseudogene",2568,2568
"ENSG00000226054","ENST00000452572",21,36130489,36131376,1,36130489,36131376,"MEMO1P1",1,43.58,"processed_pseudogene","processed_pseudogene",887,887
"ENSG00000236332","ENST00000447384",21,27361164,27395787,1,27361164,27395787,"AP001605.4",1,36.75,"lincRNA","lincRNA",34623,34623
"ENSG00000154736","ENST00000284987",21,26917912,26966513,-1,26917912,26966513,"ADAMTS5",1,38.23,"protein_coding","protein_coding",48601,48601
"ENSG00000273254","ENST00000608809",21,29024255,29024890,-1,29024255,29024890,"RP1-100J12.1",1,53.46,"antisense","antisense",635,635
"ENSG00000228600","ENST00000453699",21,14757588,14758352,1,14757588,14758352,"POLR2CP1",1,46.54,"processed_pseudogene","processed_pseudogene",764,764
"ENSG00000279615","ENST00000624852",21,8680538,8680934,-1,8680538,8680934,"bP-2168N6.1",1,49.37,"processed_pseudogene","processed_pseudogene",396,396
"ENSG00000188694","ENST00000340345",21,30281309,30282958,-1,30281309,30282958,"KRTAP24-1",1,42.55,"protein_coding","protein_coding",1649,1649
"ENSG00000235123","ENST00000427451",21,40383083,40385358,1,40383083,40385358,"DSCAM-AS1",4,42.84,"antisense","antisense",2275,2275
"ENSG00000189169","ENST00000400365",21,44697172,44698044,1,44697172,44698044,"KRTAP10-12",2,67.12,"protein_coding","protein_coding",872,872
"ENSG00000277277","ENST00000613894",21,7769796,7770546,-1,7769796,7770546,"CH507-396I9.7",1,43.14,"processed_pseudogene","processed_pseudogene",750,750
"ENSG00000225331","ENST00000411694",21,44158740,44160076,-1,44158740,44160072,"AP001055.6",2,64.55,"lincRNA","lincRNA",1336,1332
"ENSG00000238220","ENST00000411943",21,32624416,32625096,-1,32624416,32625096,"AP000275.64",1,44.79,"processed_pseudogene","processed_pseudogene",680,680
"ENSG00000280179","ENST00000624872",21,6084364,6091407,-1,6084381,6091407,"CH507-42P11.6",2,61.63,"lincRNA","lincRNA",7043,7026
"ENSG00000183250","ENST00000397841",21,44932814,44939913,-1,44932814,44939913,"LINC01547",3,54.3,"lincRNA","lincRNA",7099,7099
"ENSG00000230794","ENST00000412240",21,35713139,35732942,-1,35713139,35732942,"AF015720.3",1,42.2,"lincRNA","lincRNA",19803,19803
"ENSG00000231300","ENST00000431167",21,35599732,35600022,-1,35599732,35600022,"EZH2P1",1,40.89,"processed_pseudogene","processed_pseudogene",290,290
"ENSG00000226012","ENST00000444977",21,38237217,38238201,-1,38237217,38238201,"AP001434.2",1,47.21,"lincRNA","lincRNA",984,984
"ENSG00000182240","ENST00000347667",21,41167801,41282518,1,41167801,41282518,"BACE2",10,45.56,"protein_coding","protein_coding",114717,114717
"ENSG00000233206","ENST00000413190",21,20430443,20430762,-1,20430443,20430762,"RPS3AP1",1,41.25,"processed_pseudogene","processed_pseudogene",319,319
"ENSG00000276738","ENST00000615444",21,20597953,20598163,1,20597953,20598163,"AP001506.1",1,33.18,"processed_pseudogene","processed_pseudogene",210,210
"ENSG00000227721","ENST00000451820",21,38894917,38895252,1,38894917,38895252,"RPSAP64",1,56.55,"processed_pseudogene","processed_pseudogene",335,335
"ENSG00000280433","ENST00000623744",21,5155499,5165472,-1,5157012,5165472,"CH507-9B2.9",2,46.15,"protein_coding","retained_intron",9973,8460
"ENSG00000279579","ENST00000623794",21,8759077,8761335,1,8759077,8761335,"bP-2189O9.3",2,44.18,"lincRNA","lincRNA",2258,2258
"ENSG00000224427","ENST00000444036",21,32841496,32841811,-1,32841496,32841811,"AP000281.1",1,53.8,"processed_pseudogene","processed_pseudogene",315,315
"ENSG00000229425","ENST00000634644",21,15370500,15627342,-1,15370500,15627258,"AJ006998.2",10,37.64,"lincRNA","lincRNA",256842,256758
"ENSG00000182816","ENST00000399889",21,30371391,30372257,-1,30371391,30372257,"KRTAP13-2",1,49.6,"protein_coding","protein_coding",866,866
"ENSG00000160201","ENST00000291552",21,43092956,43107587,-1,43092956,43107587,"U2AF1",12,43.66,"protein_coding","protein_coding",14631,14631
"ENSG00000277693","ENST00000622592",21,10328411,10342737,-1,10328411,10342669,"AP003900.6",2,41.64,"lincRNA","lincRNA",14326,14258
"ENSG00000278158","ENST00000619053",21,44241847,44242081,1,44241847,44242081,"AP001059.6",1,64.68,"lincRNA","lincRNA",234,234
"ENSG00000275799","ENST00000620163",21,44244545,44244993,1,44244545,44244993,"AP001059.7",1,49.22,"lincRNA","lincRNA",448,448
"ENSG00000275945","ENST00000613970",21,10330732,10331537,1,10330732,10331537,"EIF3FP1",1,49.63,"processed_pseudogene","processed_pseudogene",805,805
"ENSG00000206104","ENST00000382826",21,30642864,30643136,1,30642864,30643136,"KRTAP20-3",1,43.22,"protein_coding","protein_coding",272,272
"ENSG00000228314","ENST00000428301",21,13843133,13848364,-1,13843133,13848364,"CYP4F29P",3,50.65,"transcribed_unprocessed_pseudogene","processed_transcript",5231,5231
"ENSG00000275592","ENST00000619242",21,10357400,10358620,1,10357400,10358620,"VN1R7P",1,45.29,"processed_pseudogene","processed_pseudogene",1220,1220
"ENSG00000230965","ENST00000412442",21,13905960,13906488,-1,13905960,13906488,"SNX18P13",1,54.06,"processed_pseudogene","processed_pseudogene",528,528
"ENSG00000224832","ENST00000416218",21,24304550,24321377,-1,24304550,24321377,"AP000469.2",1,36.15,"lincRNA","lincRNA",16827,16827
"ENSG00000237731","ENST00000420965",21,25643489,25644216,1,25643489,25644216,"RNGTTP1",1,41.35,"processed_pseudogene","processed_pseudogene",727,727
"ENSG00000240770","ENST00000430815",21,17763315,17792523,-1,17763315,17792523,"C21orf91-OT1",3,39.23,"lincRNA","lincRNA",29208,29208
"ENSG00000224100","ENST00000428410",21,42964639,42965363,-1,42964639,42965363,"AP001630.5",1,50.07,"antisense","antisense",724,724
"ENSG00000160183","ENST00000291532",21,42371890,42396846,-1,42371890,42396846,"TMPRSS3",8,50.46,"protein_coding","protein_coding",24956,24956
"ENSG00000185808","ENST00000360525",21,37059170,37073170,-1,37059170,37073158,"PIGP",8,42.2,"protein_coding","protein_coding",14000,13988
"ENSG00000186965","ENST00000334055",21,30487057,30487436,-1,30487057,30487436,"KRTAP19-2",1,48.16,"protein_coding","protein_coding",379,379
"ENSG00000184787","ENST00000345496",21,44768580,44802019,-1,44768580,44802019,"UBE2G2",12,45,"protein_coding","protein_coding",33439,33439
"ENSG00000236400","ENST00000454921",21,30741780,30742595,-1,30741780,30742595,"KRTAP21-4P",1,52.33,"unprocessed_pseudogene","unprocessed_pseudogene",815,815
"ENSG00000157551","ENST00000549805",21,38157034,38307357,1,38157034,38299406,"KCNJ15",21,41.09,"protein_coding","protein_coding",150323,142372
"ENSG00000244025","ENST00000334063",21,30491464,30491985,-1,30491464,30491985,"KRTAP19-3",1,44.44,"protein_coding","protein_coding",521,521
"ENSG00000273091","ENST00000610276",21,31735732,31736407,1,31735732,31736407,"AP000255.6",1,38.61,"lincRNA","lincRNA",675,675
"ENSG00000227054","ENST00000450769",21,25692180,25692554,1,25692180,25692554,"FDX1P2",1,41.6,"processed_pseudogene","processed_pseudogene",374,374
"ENSG00000278106","ENST00000612331",21,10397644,10397778,1,10397644,10397778,"RP11-589M2.1",1,61.48,"unprocessed_pseudogene","unprocessed_pseudogene",134,134
"ENSG00000186967","ENST00000334058",21,30496824,30497133,-1,30496824,30497133,"KRTAP19-4",1,48.71,"protein_coding","protein_coding",309,309
"ENSG00000226527","ENST00000421051",21,33111699,33123703,-1,33111699,33123703,"AP000289.6",1,45.3,"lincRNA","lincRNA",12004,12004
"ENSG00000186977","ENST00000334151",21,30501657,30502117,-1,30501657,30502117,"KRTAP19-5",1,48.81,"protein_coding","protein_coding",460,460
"ENSG00000273027","ENST00000609461",21,44929653,44930112,-1,44929653,44930112,"LL21NC02-1C16.1",1,56.96,"sense_intronic","sense_intronic",459,459
"ENSG00000228961","ENST00000424837",21,32958888,32960566,1,32958888,32960566,"AP000282.3",1,44.49,"lincRNA","lincRNA",1678,1678
"ENSG00000160307","ENST00000291700",21,46598962,46605208,-1,46598962,46605208,"S100B",3,44.31,"protein_coding","protein_coding",6246,6246
"ENSG00000160299","ENST00000359568",21,46324122,46445769,1,46324122,46445769,"PCNT",8,51.58,"protein_coding","protein_coding",121647,121647
"ENSG00000225745","ENST00000430327",21,41176322,41186788,-1,41176322,41186773,"AL773572.7",3,46.52,"antisense","antisense",10466,10451
"ENSG00000281383","ENST00000629969",21,8254592,8255514,-1,8254592,8255514,"CH507-513H4.5",1,54.82,"lincRNA","lincRNA",922,922
"ENSG00000237864","ENST00000450205",21,43322417,43332039,-1,43322417,43332039,"LINC00322",1,56.07,"lincRNA","lincRNA",9622,9622
"ENSG00000212933","ENST00000391618",21,44654213,44654659,-1,44654213,44654659,"KRTAP12-4",1,65.32,"protein_coding","protein_coding",446,446
"ENSG00000234159","ENST00000433427",21,15744004,15745080,-1,15744004,15745080,"RBPMSLP",1,52.83,"processed_pseudogene","processed_pseudogene",1076,1076
"ENSG00000230323","ENST00000414877",21,32080316,32197813,-1,32080316,32197813,"LINC00159",2,42.53,"lincRNA","lincRNA",117497,117497
"ENSG00000276647","ENST00000617417",21,44686358,44686629,1,44686358,44686629,"RP1-225L15.1",1,70.59,"processed_pseudogene","processed_pseudogene",271,271
"ENSG00000272804","ENST00000616689",21,44600597,44612906,1,44600607,44612906,"KRTAP10-7",2,48.47,"protein_coding","protein_coding",12309,12299
"ENSG00000237841","ENST00000421795",21,30510307,30510497,-1,30510307,30510497,"KRTAP19-9P",1,47.12,"unprocessed_pseudogene","unprocessed_pseudogene",190,190
"ENSG00000223488","ENST00000379571",21,22436290,22438349,-1,22436290,22438349,"MAPK6PS2",1,38.4,"processed_pseudogene","processed_pseudogene",2059,2059
"ENSG00000230859","ENST00000456507",21,40863994,40864473,1,40863994,40864473,"YRDCP3",1,50.21,"processed_pseudogene","processed_pseudogene",479,479
"ENSG00000183535","ENST00000485206",21,45419716,45425070,-1,45419716,45425070,"COL18A1-AS1",2,60.67,"antisense","antisense",5354,5354
"ENSG00000270116","ENST00000602568",21,37100814,37101343,1,37100814,37101343,"AP001429.1",1,36.04,"sense_intronic","sense_intronic",529,529
"ENSG00000273199","ENST00000608391",21,36319792,36320670,-1,36319792,36320670,"AP000692.10",1,67.35,"antisense","antisense",878,878
"ENSG00000224421","ENST00000444161",21,36388878,36389112,-1,36388878,36389112,"ATP5J2LP",1,52.77,"processed_pseudogene","processed_pseudogene",234,234
"ENSG00000228107","ENST00000397184",21,36360630,36362040,1,36360630,36362040,"AP000692.9",1,47.84,"sense_overlapping","sense_overlapping",1410,1410
"ENSG00000280145","ENST00000625185",21,6630182,6670695,-1,6630182,6670692,"CH507-154B10.1",8,38.94,"lincRNA","lincRNA",40513,40510
"ENSG00000160208","ENST00000340648",21,43659548,43696079,1,43659548,43696079,"RRP1B",2,47.51,"protein_coding","protein_coding",36531,36531
"ENSG00000230061","ENST00000423310",21,44414588,44425272,-1,44414588,44425272,"TRPM2-AS",2,57.84,"antisense","antisense",10684,10684
"ENSG00000238265","ENST00000419069",21,21723293,21737319,-1,21723293,21737319,"LINC00317",1,32.99,"lincRNA","lincRNA",14026,14026
"ENSG00000214326","ENST00000398116",21,43551229,43551600,1,43551229,43551600,"RPL31P1",1,44.09,"processed_pseudogene","processed_pseudogene",371,371
"ENSG00000237721","ENST00000419664",21,39006648,39011329,-1,39006648,39011329,"AF064858.11",1,48.93,"lincRNA","lincRNA",4681,4681
"ENSG00000160294","ENST00000397708",21,46235126,46286297,-1,46235133,46286297,"MCM3AP",10,47.4,"protein_coding","protein_coding",51171,51164
"ENSG00000279690","ENST00000624800",21,32790673,32791504,-1,32790673,32791504,"AP000280.66",1,37.98,"TEC","TEC",831,831
"ENSG00000223608","ENST00000417138",21,38006544,38010618,-1,38006544,38010618,"DSCR4-IT1",1,41.47,"sense_intronic","sense_intronic",4074,4074
"ENSG00000173638","ENST00000567670",21,45493572,45544411,-1,45498201,45544411,"SLC19A1",12,59.34,"protein_coding","protein_coding",50839,46210
"ENSG00000142185","ENST00000300482",21,44350163,44443081,1,44350163,44443081,"TRPM2",8,54.13,"protein_coding","protein_coding",92918,92918
"ENSG00000274248","ENST00000621707",21,45974489,45974953,1,45974489,45974953,"AJ011932.1",1,63.23,"lincRNA","lincRNA",464,464
"ENSG00000270533","ENST00000625012",21,9975017,10119309,-1,9975017,10119309,"bP-21201H5.1",2,33.97,"transcribed_processed_pseudogene","processed_transcript",144292,144292
"ENSG00000278878","ENST00000623225",21,6667304,6670667,-1,6667304,6670667,"CH507-145C22.3",2,37.87,"lincRNA","lincRNA",3363,3363
"ENSG00000238197","ENST00000440052",21,32728115,32743122,1,32728139,32743122,"PAXBP1-AS1",3,39.6,"antisense","antisense",15007,14983
"ENSG00000223870","ENST00000426609",21,25127469,25135247,1,25127469,25135247,"AP000233.3",1,34.13,"lincRNA","lincRNA",7778,7778
"ENSG00000159259","ENST00000314103",21,36385378,36419015,1,36385378,36419015,"CHAF1B",3,46.73,"protein_coding","protein_coding",33637,33637
"ENSG00000159128","ENST00000421802",21,33402896,33479348,1,33432319,33479348,"IFNGR2",6,44.83,"protein_coding","protein_coding",76452,47029
"ENSG00000159055","ENST00000290130",21,32268219,32279069,-1,32268219,32279069,"MIS18A",2,40.72,"protein_coding","protein_coding",10850,10850
"ENSG00000232806","ENST00000415820",21,41559125,41562958,-1,41559125,41562958,"AP001610.9",1,49.5,"lincRNA","lincRNA",3833,3833
"ENSG00000170262","ENST00000399784",21,32291813,32314784,1,32291813,32312290,"MRAP",4,46.36,"protein_coding","protein_coding",22971,20477
"ENSG00000237989","ENST00000442815",21,43358147,43362349,-1,43358147,43362349,"TCONS_00029157",1,57.41,"lincRNA","lincRNA",4202,4202
"ENSG00000231480","ENST00000442212",21,38502445,38502621,1,38502445,38502621,"SNRPGP13",1,37.85,"processed_pseudogene","processed_pseudogene",176,176
"ENSG00000219368","ENST00000406845",21,23090028,23091831,-1,23090028,23091831,"ZNF299P",1,34.37,"processed_pseudogene","processed_pseudogene",1803,1803
"ENSG00000280071","ENST00000624810",21,5079294,5128425,-1,5079294,5127927,"CH507-9B2.3",11,57.86,"protein_coding","protein_coding",49131,48633
"ENSG00000223799","ENST00000411998",21,33263873,33266260,-1,33263873,33266260,"IL10RB-AS1",1,48.16,"antisense","antisense",2387,2387
"ENSG00000279064","ENST00000623723",21,5707004,5709456,-1,5707004,5709456,"CH507-39O4.2",1,42.07,"lincRNA","lincRNA",2452,2452
"ENSG00000228433","ENST00000435600",21,32621049,32622096,1,32621049,32622096,"OR7E23P",1,48.66,"processed_pseudogene","processed_pseudogene",1047,1047
"ENSG00000234034","ENST00000441759",21,22500604,22520058,-1,22500604,22520058,"AP000959.2",1,33.59,"lincRNA","lincRNA",19454,19454
"ENSG00000267857","ENST00000596207",21,45100487,45101094,-1,45100487,45101094,"RP5-1023B21.1",1,60.53,"lincRNA","lincRNA",607,607
"ENSG00000230198","ENST00000448908",21,19593841,19594108,1,19593841,19594108,"RPL37P4",1,48.13,"processed_pseudogene","processed_pseudogene",267,267
"ENSG00000229336","ENST00000282964",21,19739709,19740150,1,19739709,19740150,"AP000568.2",1,34.16,"processed_pseudogene","processed_pseudogene",441,441
"ENSG00000182912","ENST00000465978",21,44517216,44525952,1,44517620,44525952,"TSPEAR-AS2",3,54.53,"antisense","antisense",8736,8332
"ENSG00000231058","ENST00000445341",21,23101223,23103074,1,23101223,23103074,"MSANTD2P1",1,47.35,"processed_pseudogene","processed_pseudogene",1851,1851
"ENSG00000157554","ENST00000442448",21,38380027,38661780,-1,38380030,38661780,"ERG",16,41.91,"protein_coding","protein_coding",281753,281750
"ENSG00000154734","ENST00000284984",21,26835747,26845409,-1,26835747,26845409,"ADAMTS1",6,45.12,"protein_coding","protein_coding",9662,9662
"ENSG00000264063","ENST00000577708",21,8987370,8987430,1,8987370,8987430,"MIR3687-2",1,78.69,"miRNA","miRNA",60,60
"ENSG00000229880","ENST00000435590",21,44675868,44678086,-1,44675868,44678086,"IMMTP1",1,45.79,"processed_pseudogene","processed_pseudogene",2218,2218
"ENSG00000200213","ENST00000363343",21,36066545,36066652,1,36066545,36066652,"RNU6-992P",1,42.59,"snRNA","snRNA",107,107
"ENSG00000264002","ENST00000584271",21,9902344,9902627,-1,9902344,9902627,"RN7SL52P",1,48.94,"misc_RNA","misc_RNA",283,283
"ENSG00000160213","ENST00000291568",21,43772512,43776445,-1,43772512,43776445,"CSTB",2,54.22,"protein_coding","protein_coding",3933,3933
"ENSG00000160310","ENST00000355680",21,46635167,46665124,1,46635167,46664951,"PRMT2",16,45.52,"protein_coding","protein_coding",29957,29784
"ENSG00000226751","ENST00000435315",21,14761710,14763090,-1,14761710,14763090,"AF127936.5",1,35.05,"lincRNA","lincRNA",1380,1380
"ENSG00000225502","ENST00000448152",21,14774301,14775262,1,14774301,14775262,"GAPDHP16",1,45.63,"processed_pseudogene","processed_pseudogene",961,961
"ENSG00000263681","ENST00000582241",21,41167557,41167629,1,41167557,41167629,"MIR3197",1,72.6,"miRNA","miRNA",72,72
"ENSG00000252606","ENST00000516797",21,43996322,43996420,-1,43996322,43996420,"RNU6-1150P",1,38.38,"snRNA","snRNA",98,98
"ENSG00000212932","ENST00000427757",21,46690764,46691226,1,46690764,46691226,"RPL23AP4",1,50.32,"processed_pseudogene","processed_pseudogene",462,462
"ENSG00000175894","ENST00000323084",21,44497892,44711580,-1,44497892,44711580,"TSPEAR",4,50.12,"protein_coding","protein_coding",213688,213688
"ENSG00000142173","ENST00000300527",21,46098097,46132849,1,46098097,46132849,"COL6A2",8,55.88,"protein_coding","protein_coding",34752,34752
"ENSG00000228592","ENST00000262354",21,23361104,23384861,-1,23361104,23384861,"D21S2088E",1,35.28,"lincRNA","lincRNA",23757,23757
"ENSG00000222042","ENST00000409758",21,25169431,25333825,-1,25169431,25333825,"AP000233.4",1,35.64,"lincRNA","lincRNA",164394,164394
"ENSG00000235890","ENST00000451035",21,44506807,44516575,1,44506807,44516575,"TSPEAR-AS1",2,58.67,"antisense","antisense",9768,9768
"ENSG00000273102","ENST00000607953",21,33967101,33968573,-1,33967101,33968573,"AP000569.9",1,44.53,"lincRNA","lincRNA",1472,1472
"ENSG00000280013","ENST00000623928",21,6008604,6008810,1,6008604,6008810,"CH507-42P11.2",1,58.45,"processed_pseudogene","processed_pseudogene",206,206
"ENSG00000227698","ENST00000432411",21,41874756,41877613,-1,41874756,41877613,"AP001619.2",1,51.92,"sense_intronic","sense_intronic",2857,2857
"ENSG00000213885","ENST00000425147",21,25361821,25362431,1,25361821,25362431,"RPL13AP7",1,56.96,"processed_pseudogene","processed_pseudogene",610,610
"ENSG00000225330","ENST00000416555",21,39630271,39726085,1,39630271,39726085,"AF064860.5",1,44.57,"sense_overlapping","sense_overlapping",95814,95814
"ENSG00000224413","ENST00000451618",21,46037052,46039807,1,46037052,46039807,"AP001476.2",1,59.98,"lincRNA","lincRNA",2755,2755
"ENSG00000160218","ENST00000291574",21,44012319,44106552,1,44012319,44106552,"TRAPPC10",12,46.02,"protein_coding","protein_coding",94233,94233
"ENSG00000229046","ENST00000445197",21,31706555,31706864,1,31706555,31706864,"HMGN1P2",1,45.81,"processed_pseudogene","processed_pseudogene",309,309
"ENSG00000224541","ENST00000455275",21,26158091,26175824,1,26158091,26175824,"AP001439.2",1,42.9,"antisense","antisense",17733,17733
"ENSG00000228235","ENST00000429512",21,46052596,46053105,1,46052596,46053105,"AP001476.4",1,60.39,"lincRNA","lincRNA",509,509
"ENSG00000223078","ENST00000411146",21,23281736,23281909,-1,23281736,23281909,"RNU2-55P",1,42.53,"snRNA","snRNA",173,173
"ENSG00000226115","ENST00000435738",21,46056516,46057567,1,46056516,46057567,"AP001476.3",1,62.55,"lincRNA","lincRNA",1051,1051
"ENSG00000251778","ENST00000515969",21,41882205,41882300,1,41882205,41882300,"SNORA3",1,41.67,"snoRNA","snoRNA",95,95
"ENSG00000223662","ENST00000449214",21,14582202,14598303,1,14582202,14598303,"SAMSN1-AS1",1,34.65,"antisense","antisense",16101,16101
"ENSG00000227256","ENST00000453549",21,32277863,32280988,1,32277863,32280988,"MIS18A-AS1",1,50.45,"antisense","antisense",3125,3125
"ENSG00000160226","ENST00000339818",21,44328944,44339402,-1,44328944,44339402,"C21orf2",7,60.43,"protein_coding","protein_coding",10458,10458
"ENSG00000235808","ENST00000450079",21,39488327,39488760,1,39488327,39488760,"MYL6P2",1,53.92,"processed_pseudogene","processed_pseudogene",433,433
"ENSG00000142166","ENST00000270139",21,33324477,33359862,1,33324904,33359862,"IFNAR1",3,41.3,"protein_coding","protein_coding",35385,34958
"ENSG00000185917","ENST00000399201",21,36034541,36079389,-1,36043686,36079389,"SETD4",17,44.84,"protein_coding","protein_coding",44848,35703
"ENSG00000232777","ENST00000450190",21,43115334,43115709,-1,43115334,43115709,"MRPL51P2",1,46.01,"processed_pseudogene","processed_pseudogene",375,375
"ENSG00000228149","ENST00000437106",21,36168970,36170180,-1,36168970,36170180,"RPL3P1",1,53.67,"processed_pseudogene","processed_pseudogene",1210,1210
"ENSG00000142197","ENST00000399151",21,36156782,36294274,1,36164535,36294274,"DOPEY2",4,47.09,"protein_coding","protein_coding",137492,129739
"ENSG00000237609","ENST00000440714",21,39028536,39029128,-1,39028536,39029128,"AF064858.10",1,52.45,"lincRNA","lincRNA",592,592
"ENSG00000206106","ENST00000382830",21,30590105,30590397,-1,30590105,30590397,"KRTAP22-2",1,39.25,"protein_coding","protein_coding",292,292
"ENSG00000142207","ENST00000382751",21,32311018,32393026,-1,32311018,32393026,"URB1",3,46.41,"protein_coding","protein_coding",82008,82008
"ENSG00000184032","ENST00000330798",21,30635236,30635619,1,30635236,30635619,"KRTAP20-2",1,47.14,"protein_coding","protein_coding",383,383
"ENSG00000141956","ENST00000433067",21,41798225,41879482,-1,41798225,41879482,"PRDM15",16,51.21,"protein_coding","nonsense_mediated_decay",81257,81257
"ENSG00000233036","ENST00000440620",21,30802242,30802427,-1,30802242,30802427,"KRTAP8-2P",1,50.54,"unprocessed_pseudogene","unprocessed_pseudogene",185,185
"ENSG00000185272","ENST00000468643",21,14216130,14228372,1,14216130,14228372,"RBM11",6,35.7,"protein_coding","processed_transcript",12242,12242
"ENSG00000160193","ENST00000330317",21,42843094,42879568,-1,42843094,42879531,"WDR4",7,53.71,"protein_coding","protein_coding",36474,36437
"ENSG00000159079","ENST00000290155",21,32592079,32612866,-1,32601667,32612866,"C21orf59",8,47.5,"protein_coding","protein_coding",20787,11199
"ENSG00000279769","ENST00000624240",21,6034690,6036093,1,6034690,6036093,"CH507-42P11.3",1,54.13,"TEC","TEC",1403,1403
"ENSG00000280191","ENST00000624561",21,6060340,6076305,1,6060340,6076305,"CH507-42P11.5",5,53.95,"lincRNA","lincRNA",15965,15965
"ENSG00000183527","ENST00000331573",21,39174769,39183851,-1,39174769,39183851,"PSMG1",5,41.56,"protein_coding","protein_coding",9082,9082
"ENSG00000244676","ENST00000428689",21,17793488,17810845,1,17793488,17810845,"AL109761.5",2,37.93,"antisense","antisense",17357,17357
"ENSG00000279687","ENST00000623188",21,5073458,5087867,1,5073458,5087867,"CH507-9B2.8",1,54.89,"antisense","antisense",14409,14409
"ENSG00000234052","ENST00000426418",21,27638693,27653491,1,27638693,27653491,"AP001607.1",1,34.26,"lincRNA","lincRNA",14798,14798
"ENSG00000233956","ENST00000448054",21,33518610,33519108,-1,33518610,33519108,"BTF3P6",1,40.28,"processed_pseudogene","processed_pseudogene",498,498
"ENSG00000249209","ENST00000429238",21,33584687,33931607,-1,33584687,33931607,"AP000304.12",1,42.42,"protein_coding","protein_coding",346920,346920
"ENSG00000160216","ENST00000291572",21,43865186,43986536,1,43865186,43986536,"AGPAT3",18,51.71,"protein_coding","protein_coding",121350,121350
"ENSG00000229306","ENST00000457565",21,12999676,13016692,-1,12999676,13016692,"AP001464.4",1,38.78,"lincRNA","lincRNA",17016,17016
"ENSG00000279501","ENST00000623236",21,8996496,9018670,-1,8996496,9018670,"bP-2171C21.3",1,41.52,"lincRNA","lincRNA",22174,22174
"ENSG00000279414","ENST00000623182",21,9026821,9027329,-1,9026821,9027329,"bP-2171C21.4",1,61.49,"processed_pseudogene","processed_pseudogene",508,508
"ENSG00000237735","ENST00000444868",21,16754519,16815688,-1,16754519,16815688,"AP000473.6",1,35.45,"lincRNA","lincRNA",61169,61169
"ENSG00000279381","ENST00000623217",21,9088188,9088391,1,9088188,9088391,"bP-2171C21.5",1,62.75,"processed_pseudogene","processed_pseudogene",203,203
"ENSG00000224388","ENST00000433378",21,41180097,41180626,1,41180097,41180626,"BACE2-IT1",1,48.3,"antisense","antisense",529,529
"ENSG00000280019","ENST00000624484",21,6272135,6276532,-1,6272135,6276532,"CH507-145C22.2",1,53.32,"unprocessed_pseudogene","unprocessed_pseudogene",4397,4397
"ENSG00000232010","ENST00000442785",21,44250813,44251520,1,44250813,44251520,"AP001059.5",1,62.15,"antisense","antisense",707,707
"ENSG00000272657","ENST00000362077",21,34073592,34360033,1,34073592,34360033,"AP000320.7",1,42.87,"processed_transcript","processed_transcript",286441,286441
"ENSG00000214955","ENST00000427022",21,34205055,34325034,1,34205055,34325034,"AP000318.2",1,42.7,"lincRNA","lincRNA",119979,119979
"ENSG00000160181","ENST00000291526",21,42346357,42351128,-1,42346357,42351128,"TFF2",3,53.58,"protein_coding","protein_coding",4771,4771
"ENSG00000156282","ENST00000286808",21,30165564,30166756,-1,30165564,30166756,"CLDN17",1,44.68,"protein_coding","protein_coding",1192,1192
"ENSG00000227456","ENST00000630751",21,34157724,34190244,1,34157724,34188917,"LINC00310",8,43,"lincRNA","lincRNA",32520,31193
"ENSG00000279709","ENST00000623377",21,6309161,6312948,1,6309161,6312948,"CH507-254M2.4",1,53.62,"unprocessed_pseudogene","unprocessed_pseudogene",3787,3787
"ENSG00000279062","ENST00000623954",21,10136419,10137004,1,10136419,10137004,"CH507-216K13.1",1,61.77,"unprocessed_pseudogene","unprocessed_pseudogene",585,585
"ENSG00000279864","ENST00000624736",21,9558970,9559155,1,9558970,9559155,"RP11-570J4.1",1,37.63,"processed_pseudogene","processed_pseudogene",185,185
"ENSG00000234340","ENST00000433524",21,22134698,22136083,-1,22134698,22136083,"AP000705.8",1,40.98,"processed_pseudogene","processed_pseudogene",1385,1385
"ENSG00000270835","ENST00000632732",21,38204141,38206080,-1,38204141,38206080,"AP001425.14",2,42.89,"transcribed_processed_pseudogene","processed_transcript",1939,1939
"ENSG00000279186","ENST00000624506",21,5703182,5705637,-1,5703182,5705637,"CH507-39O4.3",1,35.67,"TEC","TEC",2455,2455
"ENSG00000279784","ENST00000623587",21,5705345,5707160,1,5705345,5707160,"CH507-39O4.1",1,44.77,"lincRNA","lincRNA",1815,1815
"ENSG00000212935","ENST00000391620",21,44557790,44558760,-1,44557790,44558760,"KRTAP10-3",1,65.29,"protein_coding","protein_coding",970,970
"ENSG00000233442","ENST00000450880",21,14007134,14014880,1,14007134,14014880,"PPP6R2P1",1,62.17,"unprocessed_pseudogene","unprocessed_pseudogene",7746,7746
"ENSG00000155304","ENST00000285667",21,14371115,14383484,-1,14371115,14383187,"HSPA13",2,36.7,"protein_coding","protein_coding",12369,12072
"ENSG00000235888","ENST00000417335",21,38988707,39006153,-1,38988707,39006153,"AF064858.8",1,48.46,"lincRNA","lincRNA",17446,17446
"ENSG00000279895","ENST00000624042",21,7421442,7425839,-1,7421442,7425839,"CH507-254M2.6",1,53.32,"unprocessed_pseudogene","unprocessed_pseudogene",4397,4397
"ENSG00000276077","ENST00000625096",21,7430659,7469007,1,7430669,7468875,"CH507-254M2.2",7,39.65,"lincRNA","lincRNA",38348,38206
"ENSG00000237325","ENST00000490865",21,31452466,31453223,1,31452466,31453223,"AP000563.2",1,39.97,"processed_pseudogene","processed_pseudogene",757,757
"ENSG00000227716","ENST00000433101",21,23477641,23490724,1,23477641,23490724,"AP000459.7",1,32.25,"lincRNA","lincRNA",13083,13083
"ENSG00000259981","ENST00000565564",21,30089717,30097836,1,30089717,30097836,"AF096876.1",1,35.57,"lincRNA","lincRNA",8119,8119
"ENSG00000154645","ENST00000400128",21,17901263,18267373,1,17901263,18267373,"CHODL",7,37.04,"protein_coding","protein_coding",366110,366110
"ENSG00000234509","ENST00000449339",21,31653593,31659500,-1,31653593,31659500,"AP000253.1",1,49.46,"lincRNA","lincRNA",5907,5907
"ENSG00000274559","ENST00000464664",21,5972956,5973333,-1,5972956,5973333,"CH507-42P11.1",1,61.9,"processed_pseudogene","processed_pseudogene",377,377
"ENSG00000279788","ENST00000624266",21,6676178,6679962,-1,6676178,6679962,"CH507-154B10.3",1,53.66,"unprocessed_pseudogene","unprocessed_pseudogene",3784,3784
"ENSG00000142188","ENST00000420455",21,33432485,33480011,-1,33432485,33479943,"TMEM50B",10,43.36,"protein_coding","nonsense_mediated_decay",47526,47458
"ENSG00000186971","ENST00000334068",21,30430230,30431026,1,30430230,30431026,"KRTAP13-4",1,47.3,"protein_coding","protein_coding",796,796
"ENSG00000279728","ENST00000623809",21,6712596,6716361,1,6712596,6716361,"CH507-236L23.5",1,53.51,"unprocessed_pseudogene","unprocessed_pseudogene",3765,3765
"ENSG00000232608","ENST00000419324",21,39216624,39217506,1,39216624,39217506,"TIMM9P2",1,39.41,"processed_pseudogene","processed_pseudogene",882,882
"ENSG00000156239","ENST00000303775",21,28872191,28885371,-1,28872191,28885371,"N6AMT1",3,38.62,"protein_coding","protein_coding",13180,13180
"ENSG00000279534","ENST00000624405",21,25371827,25372043,1,25371827,25372043,"AP001340.3",1,34.56,"TEC","TEC",216,216
"ENSG00000160199","ENST00000432907",21,42974510,43033931,1,42974510,43033931,"PKNOX1",11,46.99,"protein_coding","protein_coding",59421,59421
"ENSG00000185433","ENST00000441013",21,25385820,25431701,-1,25385820,25431701,"LINC00158",4,37.89,"lincRNA","lincRNA",45881,45881
"ENSG00000273840","ENST00000612267",21,10482738,10605716,1,10482738,10605716,"AL078471.5",1,38.79,"processed_transcript","processed_transcript",122978,122978
"ENSG00000226043","ENST00000444130",21,22209939,22420819,1,22209939,22420819,"AP000705.7",1,34.43,"lincRNA","lincRNA",210880,210880
"ENSG00000157578","ENST00000288350",21,39405844,39445805,-1,39405844,39445777,"LCA5L",21,41.25,"protein_coding","protein_coding",39961,39933
"ENSG00000223692","ENST00000442434",21,46462471,46469306,1,46462471,46469306,"DIP2A-IT1",1,40.16,"sense_intronic","sense_intronic",6835,6835
"ENSG00000283051","ENST00000635001",21,42777819,42779994,-1,42777819,42779994,"KB-51A8.1",1,56.02,"lincRNA","lincRNA",2175,2175
"ENSG00000156304","ENST00000286835",21,31671033,31732075,-1,31671033,31732075,"SCAF4",6,38.12,"protein_coding","protein_coding",61042,61042
"ENSG00000159082","ENST00000382491",21,32628759,32728048,-1,32628759,32728040,"SYNJ1",11,38.08,"protein_coding","protein_coding",99289,99281
"ENSG00000235012","ENST00000411867",21,39525583,39529855,1,39525583,39529855,"AF121897.4",1,52.73,"processed_pseudogene","processed_pseudogene",4272,4272
"ENSG00000213440","ENST00000416034",21,44046347,44047041,-1,44046347,44047041,"H2AFZP1",1,52.66,"processed_pseudogene","processed_pseudogene",694,694
"ENSG00000182871","ENST00000400337",21,45405137,45513720,1,45405137,45513720,"COL18A1",7,59.66,"protein_coding","protein_coding",108583,108583
"ENSG00000215455","ENST00000400375",21,44538981,44540195,-1,44538981,44540195,"KRTAP10-1",1,66.34,"protein_coding","protein_coding",1214,1214
"ENSG00000221864","ENST00000360770",21,44666189,44666927,-1,44666189,44666927,"KRTAP12-2",1,60.49,"protein_coding","protein_coding",738,738
"ENSG00000215734","ENST00000400819",21,36994643,36995075,1,36994643,36995075,"MRPL20P1",1,54.73,"processed_pseudogene","processed_pseudogene",432,432
"ENSG00000160207","ENST00000291560",21,43529192,43659493,-1,43529192,43659493,"HSF2BP",2,43.01,"protein_coding","protein_coding",130301,130301
"ENSG00000277282","ENST00000622028",21,10649400,10649835,-1,10649400,10649835,"IGHV1OR21-1",1,53.67,"IG_V_gene","IG_V_gene",435,435
"ENSG00000154727","ENST00000354828",21,25734570,25772460,1,25734570,25772460,"GABPA",3,36.67,"protein_coding","protein_coding",37890,37890
"ENSG00000178457","ENST00000324988",21,28013363,28023233,1,28013363,28023233,"LINC00314",1,39.89,"lincRNA","lincRNA",9870,9870
"ENSG00000183486","ENST00000330714",21,41361943,41409390,1,41361943,41408943,"MX2",13,49.71,"protein_coding","protein_coding",47447,47000
"ENSG00000141959","ENST00000349048",21,44300051,44327376,1,44300051,44327376,"PFKL",12,63.48,"protein_coding","protein_coding",27325,27325
"ENSG00000230972","ENST00000421604",21,23065491,23131206,1,23065491,23131206,"AP001255.2",1,33.77,"lincRNA","lincRNA",65715,65715
"ENSG00000275895","ENST00000624739",21,6484623,6499261,-1,6484661,6499261,"U2AF1L5",11,43.61,"protein_coding","retained_intron",14638,14600
"ENSG00000226996","ENST00000434859",21,24043257,24050286,1,24043257,24050286,"AP000477.3",2,35.43,"lincRNA","lincRNA",7029,7029
"ENSG00000237484","ENST00000415182",21,24428740,24547942,1,24428781,24547942,"AP000476.1",3,34.59,"lincRNA","lincRNA",119202,119161
"ENSG00000232193","ENST00000440372",21,18917934,18935859,-1,18917934,18935859,"AL157359.4",1,35.35,"lincRNA","lincRNA",17925,17925
"ENSG00000239930","ENST00000416179",21,42496539,42497443,1,42496539,42497443,"AP001625.4",1,56.8,"sense_intronic","sense_intronic",904,904
"ENSG00000237664","ENST00000416722",21,45338590,45341990,-1,45338590,45341990,"LINC00316",1,45.84,"lincRNA","lincRNA",3400,3400
"ENSG00000229382","ENST00000445242",21,45336707,45338665,1,45336707,45338665,"BX322557.13",1,52.12,"lincRNA","lincRNA",1958,1958
"ENSG00000274225","ENST00000617205",21,44477850,44478493,1,44477850,44478493,"KB-68A7.1",1,49.84,"lincRNA","lincRNA",643,643
"ENSG00000184724","ENST00000329122",21,30613431,30613930,-1,30613431,30613930,"KRTAP6-1",1,49,"protein_coding","protein_coding",499,499
"ENSG00000214889","ENST00000419943",21,36132450,36133032,1,36132450,36133032,"RPS9P1",1,54.2,"processed_pseudogene","processed_pseudogene",582,582
"ENSG00000238257","ENST00000424582",21,30762682,30762882,-1,30762682,30762882,"AP000244.11",1,46.27,"unprocessed_pseudogene","unprocessed_pseudogene",200,200
"ENSG00000214914","ENST00000453844",21,36016079,36016546,-1,36016079,36016546,"RPL23AP3",1,48.29,"processed_pseudogene","processed_pseudogene",467,467
"ENSG00000157538","ENST00000399000",21,37223420,37267919,-1,37223420,37267919,"DSCR3",13,44.22,"protein_coding","processed_transcript",44499,44499
"ENSG00000160182","ENST00000291527",21,42362282,42366594,-1,42362282,42366594,"TFF1",1,53.81,"protein_coding","protein_coding",4312,4312
"ENSG00000243927","ENST00000488492",21,34073224,34143034,1,34073224,34143034,"MRPS6",5,40.3,"protein_coding","processed_transcript",69810,69810
"ENSG00000198743","ENST00000381151",21,34073570,34106262,1,34073570,34106262,"SLC5A3",1,39.03,"protein_coding","protein_coding",32692,32692
"ENSG00000224598","ENST00000415238",21,34135432,34136071,-1,34135432,34136071,"RPS5P2",1,53.91,"processed_pseudogene","processed_pseudogene",639,639
"ENSG00000185437","ENST00000380637",21,39445855,39515506,1,39445855,39515506,"SH3BGR",9,40.49,"protein_coding","protein_coding",69651,69651
"ENSG00000242553","ENST00000440629",21,37221419,37237744,1,37221419,37237744,"AP001432.14",1,46.67,"lincRNA","lincRNA",16325,16325
"ENSG00000160255","ENST00000397850",21,44885953,44931989,-1,44885953,44928873,"ITGB2",24,57.45,"protein_coding","protein_coding",46036,42920
"ENSG00000279493","ENST00000624081",21,5011799,5017145,1,5011799,5017145,"CH507-9B2.2",1,60.5,"protein_coding","protein_coding",5346,5346
"ENSG00000223901","ENST00000626933",21,46220269,46225364,1,46220344,46225364,"AP001469.5",2,52.83,"antisense","antisense",5095,5020
"ENSG00000228404","ENST00000415026",21,46185079,46188941,1,46185079,46188941,"AP001468.58",1,44.89,"antisense","antisense",3862,3862
"ENSG00000237202","ENST00000424255",21,13120244,13120807,1,13120244,13120807,"AJ239321.3",1,42.55,"processed_pseudogene","processed_pseudogene",563,563
"ENSG00000277117","ENST00000620481",21,5022493,5040666,1,5022493,5040666,"CH507-9B2.1",5,58.05,"protein_coding","protein_coding",18173,18173
"ENSG00000175302","ENST00000451052",21,13384249,13427773,-1,13384249,13427773,"ANKRD30BP1",1,34.64,"unprocessed_pseudogene","unprocessed_pseudogene",43524,43524
"ENSG00000154640","ENST00000348354",21,17593653,17612947,-1,17593653,17612947,"BTG3",6,37.74,"protein_coding","protein_coding",19294,19294
"ENSG00000160223","ENST00000407780",21,44222991,44240966,-1,44222991,44240945,"ICOSLG",4,57.74,"protein_coding","protein_coding",17975,17954
"ENSG00000229761","ENST00000434853",21,35724747,35725100,-1,35724747,35725100,"RPS20P1",1,43.79,"processed_pseudogene","processed_pseudogene",353,353
"ENSG00000159216","ENST00000475045",21,34787801,36004667,-1,34887046,36004667,"RUNX1",17,41.54,"protein_coding","protein_coding",1216866,1117621
"ENSG00000226204","ENST00000449840",21,18953264,18967058,-1,18953264,18967058,"AL157359.3",1,33.35,"lincRNA","lincRNA",13794,13794
"ENSG00000154642","ENST00000284881",21,17788967,17819386,-1,17788967,17819386,"C21orf91",6,37.16,"protein_coding","protein_coding",30419,30419
"ENSG00000215562","ENST00000400583",21,13826696,13827627,1,13826696,13827627,"CNN2P7",1,57.94,"processed_pseudogene","processed_pseudogene",931,931
"ENSG00000273210","ENST00000608783",21,37365477,37365932,-1,37365477,37365932,"AP001437.1",1,47.15,"antisense","antisense",455,455
"ENSG00000235374","ENST00000429427",21,45070952,45074165,-1,45071733,45074165,"SSR4P1",3,58.09,"transcribed_processed_pseudogene","processed_transcript",3213,2432
"ENSG00000185186","ENST00000332440",21,43462094,43479534,-1,43462094,43478223,"LINC00313",7,54.68,"lincRNA","lincRNA",17440,16129
"ENSG00000230366","ENST00000454482",21,37208503,37221736,1,37208503,37221736,"DSCR9",5,45.81,"lincRNA","lincRNA",13233,13233
"ENSG00000160285","ENST00000356396",21,46188141,46228824,-1,46188141,46228822,"LSS",11,53.33,"protein_coding","protein_coding",40683,40681
"ENSG00000233300","ENST00000420241",21,27367014,27367947,-1,27367014,27367947,"EIF4A1P1",1,46.9,"processed_pseudogene","processed_pseudogene",933,933
"ENSG00000219592","ENST00000406229",21,27492118,27492261,1,27492118,27492261,"NCSTNP1",1,40.97,"processed_pseudogene","processed_pseudogene",143,143
"ENSG00000168122","ENST00000427301",21,13095305,13113790,-1,13095305,13113790,"ZNF355P",1,34.06,"unprocessed_pseudogene","unprocessed_pseudogene",18485,18485
"ENSG00000184900","ENST00000479153",21,44805617,44818779,-1,44805617,44818779,"SUMO3",6,54.29,"protein_coding","processed_transcript",13162,13162
"ENSG00000160221","ENST00000291577",21,44133605,44145723,1,44133605,44145723,"C21orf33",11,58.55,"protein_coding","protein_coding",12118,12118
"ENSG00000249624","ENST00000433395",21,33246774,33283212,1,33246774,33283212,"AP000295.9",2,44.41,"protein_coding","protein_coding",36438,36438
"ENSG00000160284","ENST00000330205",21,46161148,46184476,-1,46161148,46184476,"SPATC1L",2,50.77,"protein_coding","protein_coding",23328,23328
"ENSG00000231125","ENST00000457162",21,29058073,29060095,-1,29058073,29060095,"AF129075.5",1,40.43,"sense_intronic","sense_intronic",2022,2022
"ENSG00000274060","ENST00000616483",21,8249505,8249596,1,8249505,8249596,"MIR6724-2",1,83.7,"miRNA","miRNA",91,91
"ENSG00000283300","ENST00000637157",21,28743208,28743291,1,28743208,28743291,"U6",1,44.05,"snRNA","snRNA",83,83
